Alejandro 	Alexander (Aleksandro)
Alemania 	Germany (Germanujo)
Alpes 	Alps (Alpoj)
Amberes 	Antwerp (Antverpeno)
Amsterdam 	Amsterdam (Amsterdamo)
Andorra 	Andorra (Andoro)
Antillas 	Antilles (Antiloj)
Apocalipsis 	Apocalypse (Apokalipso)
Arabia 	Arabia (Arabujo)
Argel 	Algiers (Al?ero)
Argentina 	Argentina (Argentino)
Arizona 	Arizona (Arizono)
Aruba 	Aruba (Arubo)
Asia 	Asia (Azio)
Asia Menor 	AsiaMinor (MalgrandaAzio)
Asturias 	Asturias (Asturujo)
Atenas 	Australia 	Australia (A?stralio)
Austria 	Austria (A?strujo)
Balkanes 	Balkans (Balkanoj)
Barcelona 	Bengala 	Bengal (Bengalujo)
Biblia 	Bible (Biblio)
Blanca?Nieve 	LittleSnowWhite (Ne?ulino)
Bolivia 	Bolivia (Bolivio)
Brasil 	Brazil (Brazilo)
Bruselas 	Brussels (Bruselo)
Bulgaria 	Bulgaria (Bulgarujo)
Burdeos 	Bordeaux (Burdegalo)
Candelaria 	Candlemas (Kandelfesto)
Castilla 	Castile (Kastilujo)
Cenicienta 	Cinderella (Cindrulino)
Cenopegias 	FeastofTabernacles (Tendofesto)
Checoeslovaquia 	Czechoslovakia (?e?oslovakujo)
Chile 	Chile (?ilio)
China 	China (?inujo)
Colombia 	Colombia (Kolombio)
Colonia 	Cologne (Kolonjo)
Costa Brava 	CostaBrava (Kostabravo)
Costa Rica 	CostaRica (Kostariko)
Creta 	Crete (Kreto)
Cristo 	Christ (Kristo)
Cruz Roja 	RedCross (Ru?aKruco)
Cuba 	Cuba (Kubo)
Curazao 	Dinamarca 	Denmark (Danujo)
Dios 	God (Dio)
Ecuador 	Ecuador (Ekvadoro)
Egipto 	Egypt (Egiptujo)
El Salvador 	ElSalvador (Elsalvadoro)
Escalda 	Scheldt (Skeldo)
Escandinavia 	Scandinavia (Skandinavio); Scandinavia (Skandinavujo)
Escocia 	Scotland (Skotujo)
Estados Unidos 	UnitedStatesofAmerica, USA (Usono)
Estonia 	Estonia (Estonujo)
Estrasburgo 	Strasbourg (Strasburgo)
Estrecho de Gibraltar 	StraitofGibraltar (?ibraltaraMarkolo)
Etna 	Etna (Etno)
Europa 	Europa occidental 	WesternEurope (OkcidentaE?ropo)
Extremadura 	Estremadura (Estremaduro)
Extremo Oriente 	FarEast, the F a r E a s t (EkstremaOriento); FarEast (MalproksimaOriento)
Finlandia 	Finland (Finnujo)
Flandes 	Flanders (Flandrujo)
Florencia 	Francia 	France (Francujo)
Frisia 	Friesland (Frizonujo)
Gales 	Wales (Kimrujo)
Galicia 	Galicia (Galegujo)
Gante 	Ghent (Gento)
Gibraltar 	Gibraltar (?ibraltaro)
Ginebra 	Geneva (?enevo)
Grecia 	Greece (Grekujo)
Groenlandia 	Greenland (Grenlando); Greenland (Groenlando)
Guatemala 	Guatemala (Gvatemalo); GuatemalaCity (Gvatemalurbo)
Guinea Ecuatorial 	EquatorialGuinea (EkvatoraGvineo)
Havana 	Havana (Havano)
Holanda 	Holland (Holando); Holland, the N e t h e r l a n d s (Nederlando)
Holanda septentrional 	NorthHolland (Nordholando)
Honduras 	Honduras (Honduraso)
IVA 	VAT (aldonvaloraimposto)
India 	India (Hindujo)
Indonesia 	Indonesia (Indonezio)
Inglaterra 	England (Anglio); England (Anglujo)
Irlanda 	Ireland (Irlando)
Islandia 	Iceland (Islando)
Islas Baleares 	BalearicIslands (Balearoj)
Islas Canarias 	CanaryIslands (KanariajInsuloj)
Islas Malvinas 	FalklandIslands, Falklands (Falklandoj)
Italia 	Italy (Italujo)
Java 	Java (Javo)
Jesucristo 	JesusChrist (JesuoKristo)
Laponia 	Lapland (Laponujo)
Latvia 	Latvia (Latvujo)
La Haya 	TheHague (Hago)
Letonia 	Latvia (Latvujo)
Lieja 	Lisboa 	Lisbon (Lisbono)
Lituania 	Lithuania (Litovujo)
Livonia 	Livonia (Livonujo)
Londres 	London (Londono)
Lorena 	Lorraine, Lothringen (Loreno)
Lovaina 	Louvain (Loveno)
Luxemburgo 	Madrid 	Madrid (Madrido)
Mahoma 	Mohammed, Muhammad (Mahometo)
Malinas 	Malines, Mechlin (Me?lino)
Mallorca 	Majorca (Majorko)
Marruecos 	Morocco (Maroko)
Marsella 	Marseilles (Marseljo)
Mosa 	Meuse (Mozo)
Mosela 	Moselle (Mozelo)
Munich 	Munich (Mun?eno)
Navidad 	Christmas, Yule (Kristnasko)
Nicaragua 	Nicaragua (Nikaragvo)
Nilo 	Nile (Nilo)
Nimega 	Nimwegen (Nimego)
Noruega 	Norway (Norvegujo)
Nueva Gales del Sur 	NewSouthWales (NovaSudkimrujo)
Nueva York 	NewAmsterdam, NewYork, NewYorkCity (Novjorko)
Paraguay 	Paraguay (Paragvajo)
Pascua 	Easter (Pasko)
Patagonia 	Patagonia (Patagonio)
Persia 	Persia (Persujo)
Pirineos 	Pyrenees (Pireneoj)
Polonia 	Poland (Polujo)
Portugal 	Portugal (Portugalujo)
Prusia 	Prussia (Prusujo)
Redentor 	Redeemer, Saviour (Ela?etinto); Redeemer, Saviour (Redemptoro); Saviour (Savinto)
Rin 	Rhine (Rejno)
Rio Brava 	RioGrande (Riobravo)
Rio Grande del Norte 	RioGrande (Riobravo)
Roma 	Rome (Romo)
Rumania 	Romania (Rumanio); Romania (Rumanujo)
Rusia 	Russia (Rusujo)
Sahara 	Sahara (Saharo)
Sajonia 	Saxe, Saxony (Saksio); Saxe, Saxony (Saksujo)
Salvador 	Redeemer, Saviour (Ela?etinto); Redeemer, Saviour (Redemptoro); Saviour (Savinto)
Sevilla 	Seville (Seviljo)
Siberia 	Siberia (Siberio)
Suecia 	Sweden (Svedujo)
Suiza 	Switzerland (Svisujo)
Surinam 	Surinam (Surinamo)
Tajo 	Tagus (Tago)
Todos los Santos 	AllHallows, AllSaints'Day (SanktularaFesto); AllSouls'Day (TagodelaMortintoj)
Trinidad 	Trinity (Triunuo)
Union Europea 	EuropeanUnion (E?ropaUnio)
Uruguay 	Uruguay (Urugvajo)
Valencia 	Venezuela 	Venezuela (Venezuelo)
Viena 	Vienna (Vieno)
Viernes Santo 	GoodFriday (SanktaVendredo)
Vizcaya 	Biscay (Biskajio); Biscay (Biskajujo)
Yugoeslavia 	Yugoslavia (Jugoslavujo)
Zelandia 	Zealand (Zelando)
a 	at, to, toward, towards (al); a, in, inside, into, on, per, within (en)
abad 	abbot (abato); abbot (lamaestro); arc him and rite (mona?estro)
abadesa 	abbess (abatino)
abajo 	below, downstairs, underneath (malsupre); below, underneath (sube)
abandonar 	cede, give in, give up, give way, relinquish, yield (cedi); abandon, forsake, desert, leave, quit (forlasi)
abastacimiento 	catering (proviantado); catering (provizumado)
abatido 	dejected, depressed (korpremita)
abedul 	birch (betulo)
abeja 	bee (abelo)
abeto 	fir (abio)
abierto 	open (malfermita); open (nefermita)
abismo 	abyss, chasm, gulf, precipice (abismo)
abjurar 	abjure, forswear, swear off, renounce (forlasi?ure)
abolas 	bearing (lagro)
abolir 	abolish, abrogate (aboli); do away with, get rid of, remove (forigi)
abominable 	abhorrent, abominable, alien, awful, hideous, horrible, gruesome (abomeninda)
abonado 	subscriber (abonanto)
abonar 	fertilize (sterki)
abonarse 	subscribe, subscribe to (ekaboni)
abono 	subscription (abono); dressing, fertilization, manuring (sterkado)
abordaje 	collision (kolizio)
abordar 	land (albordi?i); collide with, crash into (koliziikun)
abrazar 	embrace (brakumi); embrace, hug (?irka?braki)
abrelatas 	can opener, tin ? o p e n e r (skatolmalfermilo)
abreviar 	abbreviate, a bridge, shorten (mallongigi)
abreviatura 	abbreviation (mallongigo)
abridor de tapones 	bottle opener (botelmalfermilo)
abrigo 	cloak, mantle (mantelo); coat, overcoat (palto); coat, overcoat (surtuto)
abril 	April (aprilo)
abrir 	open, open up (malfermi)
abrogar 	abolish, abrogate (aboli); do away with, get rid of, remove (forigi)
absceso 	abscess (absceso)
abstinencia 	teetotal is m, total abstinence (abstemio)
abuela 	grandmother (avino)
abuelo 	grandfather (avo)
aburrido 	boring, stodgy (enuiga); boring, stodgy, tiresome (teda)
aburrir 	bore (tedi)
acabado 	finishing off (finaprilaborado); completed, done, finished, over, through (finita)
acabar 	finish, workout (ellabori); accomodate, end, finish, terminate (fini); finish (finlabori); use up (forkonsumi); use up (foruzi); waste (mal?pari)
academia 	academy (akademio)
acampar 	camp, been camped, lie encamped, camp out (kampadi)
acaso 	a cci den ce, chance, hazard (hazardo)
accidente 	accident (akcidento)
accionista 	shareholder (akciulo)
acechar 	set a trap, set a trap for (insidi)
aceite 	oil (oleo)
aceite de oliva 	oil of olives, olive ? o i l (olivoleo)
aceituna 	olive (olivo)
acelerador 	accelerator, accelerator pedal (akcelilo); accelerator, accelerator pedal (gaspedalo)
acento 	accent, stress (akcento); accent (prononcmaniero); accent mark, super sign (supersigno)
acentuar 	accent, accentuate, stress (akcenti)
aceptable 	acceptable (akceptebla); acceptable (akceptinda)
aceptar 	accept, receive, take, take in (akcepti)
acera 	pavement, sidewalk (trotuaro)
acercarse 	advance, come close, come closer, come on (alproksimi?i)
acero 	steel (?talo)
acertar 	catch, hit, run across, strike (trafi)
achicoria 	chicory (cikorio)
acoger 	greet, salute (saluti)
acogida 	greeting, salutation (salutado)
acometer 	commit aggression (agresi); assault, attack (ataki); assault, violate (atenci)
acometida 	access, aggression, attack (atako)
acomodado 	in easy circumstances, well ? t o ? d o (bonhava)
acomodar 	accomodate (akomodi)
aconsejar 	advise, counsel (konsili)
acontecer 	become, come about, grow, happen (fari?i); come about, happen, occur (okazi)
acontecimiento 	chance, event, occur en ce, opportunity (okazo)
acordar 	accede, agree, consent (konsenti)
acordarse 	think (pensi)
acorde 	acortar 	abbreviate, a bridge, shorten (mallongigi)
acostar 	put to bed (enlitigi)
acostarse 	goto bed (enliti?i)
acostumbrarse 	accustom oneself, get used (kutimi?i)
activo 	active (agema); active, in action (aktiva); assets (aktivo); active, hardworking (laborema); transitive (transitiva)
actor 	actor (aktoro)
actriz 	actress (aktorino)
actual 	current, present, present ? d a y, topical, up ? t o ? d a t e (aktuala)
actualmente 	at present, now (nun)
acuarela 	water ? c o l o u r (akvarelo)
acuario 	aquarium (akvario)
acuerdo 	acumulador 	accumulator, battery, storage battery (akumulatoro)
acusado 	accused, defendant (akuzito); accused, defendant (kulpigito)
acusar 	accuse (akuzi); accuse, denounce (denunci); accuse (plendikontra?)
adaptar 	accomodate (akomodi); affiliate (filiigi)
adelantar 	overhaul, overtake, pass (devanci); overhaul, overtake, pass (preterveturi)
adelante 	ahead, fore ward, on (anta?en)
adelgazar 	fall away, lose, lose flesh, lose in weight (malplipezi?i)
adiestrar 	tame, train (dresi); break (obeigi)
adivinar 	guess (diveni)
adjetivo 	adjective (adjektivo)
administrador 	manager (administranto); administrator (administristo)
administrar 	administer, manage (administri)
admirar 	admire (admiri)
admisible 	acceptable (akceptebla); acceptable (akceptinda)
admitir 	accept, receive, take, take in (akcepti)
adoptivo 	adopted (adoptita)
adorar 	adore, worship (adori)
adornado 	adorned (ornamita)
aduana 	customs (dogano)
adular 	flatter (flati)
adverbio 	adverb (adverbo)
advertidor de incendios 	fire ? a l a r m, fire call (brulavertilo)
adyacente 	adjacent (apuda); adjacent, adjoining (limtu?anta); adjacent, nearby, neighbouring (najbara)
aeroplano 	aeroplane, airplane, plane (aeroplano)
aeropuerto 	aerodrome, aird rome, airfield (aerodromo); airport (aerohaveno); airport (flughaveno)
afable 	lovable (aminda)
afectar 	affect (afekcii)
afectuosidad 	adherence, attachment (alligiteco); adherence, affection, attachment (sindoneco); attac he ment (sindonemo); attachment (sindono)
afectuoso 	affectionate, devoted, selfless (sindona); devoted, selfless (sindonema)
afeitar 	s have (razi)
aficionado 	amateur, fancier (amatoro)
afligido 	sad (afliktita); bleak, dismal, dreary, gaunt, miserable, sad, somber (malgaja); dismal, gaunt, miserable, sad (mal?oja)
afligir 	afflict, grieve (aflikti); afflict, cause pain, cause pain to, distress, give pain to (mal?ojigi)
africana 	Africanwoman (afrikanino)
africano 	African (afrika); African (afrikano)
agarrar 	grasp (ekpreni); clutch, grapple (ekteni)
agencia 	agency (agenteco)
agencia de viaje 	tourist agency, travel agency (voja?agentejo)
agenda 	agenda, appointment book (agendo)
agente 	agent (agento)
agilidad 	expertness, skilful ness, skill, skillful ness (lerteco)
agosto 	August (a?gusto)
agotado 	exhausted, tired out, worn out (lacega)
agradable 	agreeable, enjoyable, lovely, nice, pleasant (agrabla); comfortable (komforta); pleasing (pla?a)
agradar 	please (pla?i)
agradecer 	thank (danki)
agrado 	pleasure (pla?o)
agrario 	agrarian, agricultural, farm ? (agrara)
agresor 	aggressor, assailant, attacker (atakanto)
agridulce 	sweet ? a n d ? s o u r (dol?amara)
agrio 	ace to us, acid, sour, tart (acida); acid (acido)
agua 	water (akvo)
aguardar 	bide, abide, stay for, wait, await, wait for (?isatendi)
aguas 	spa (banurbo)
agua dolce 	freshwater (sensalaakvo)
agua dulce 	freshwater (dol?aakvo)
agua potable 	drinking ? w a t e r (trinkeblaakvo)
agudo 	acute (akuta)
aguja 	needle (kudrilo)
agujero 	hole (truo)
ah 	ah, aha (ha); oh (ho)
ahogarse 	drown (droni)
ahora 	at present, now (nun); currently, nowadays, these days (nuntempe)
ahora mismo 	at once, immediately, just, right away, right now (tuj)
ahumado 	smoked (fuma?ita)
aire 	air (aero)
aire acondicionado 	air conditioning (klimatizilo); air conditioning (klimatizo)
aislado 	remote (izolita)
aislamiento 	insulation, isolation (izolado); isolation, separation (izoliteco)
ajuar 	furniture (meblaro)
ajustar 	make a contract (kontrakti); adjust (re?ustigi)
ala 	wing (flugilo)
alabar 	commend, laud, praise (la?di)
alambre 	wire (drato); wire, iron wire (ferdrato)
alargar 	give (doni); hand, handover (enmanigi); extend, str ech out (etendi); pass, spend (pasigi); lengthen (plilongigi); convey, hand, handover, pass (transdoni)
alarma 	alarm (alarmo)
albaricoque 	apricot (abrikoto)
albaricoquero 	apricot ? t r e e (abrikotarbo); apricot ? t r e e (abrikotujo)
albergue 	hostel, inn (gastejo)
albergue juvenil 	youth hostel (junulargastejo)
alcachofa 	artichoke (arti?oko)
alcade 	mayor (urbestro); burgomaster, mayor, provost (vila?estro)
alcanzable 	accessible (atingebla)
alcanzar 	achieve, acquire, attain, get, obtain (akiri); accomplish, achieve, attain, get, reach (atingi)
alcohol 	alcohol, booze, liquor, spirits, strong drink (alkohola?o); alcohol (alkoholo)
alcohol de quemar 	methyl a ted spirit (brulalkoholo)
aldea 	village (vila?o)
alegre 	happy, glad (?oja)
alemana 	German, Germanwoman (germanino)
alentar 	encourage (kura?igi)
aleta 	fin (na?ilo)
alfabeto 	alphabet (alfabeto)
alfiler 	pin, needle (pinglo)
alfombra 	carpet (tapi?o)
algo 	anything, something (io)
alguien 	a, any, anybody, some, somebody, one, someone, someone (iu)
alguno 	a, any, anybody, some, somebody, one, someone, someone (iu)
alhaja 	adornment, decoration, ornament (ornama?o); adornment, ornament (ornamo)
aliento 	breath (spiro)
alimentar 	feed, nourish (nutri)
alimento 	food, nourishment (nutra?o)
alistar 	recruit (rekrutigi); recruit (varbi)
alma 	soul (animo)
almanaque 	almanac (almanako)
almeja 	mussel (mitulo)
almendra 	almond (migdalo)
almirante 	admiral (admiralo)
almohada 	pillow (kapkuseno); cushion (kuseno)
almorranas 	hae mor hoi ds (hemoroidoj)
almorzar 	lunch (meztagman?i)
almuerzo 	lunch, snack (lun?o)
alojamiento 	accommodation (tranoktejo)
alojarse 	be a guest of, stay with (gasti); be on a visit, stay, stop (gastlo?i)
alondra 	lark (ala?do)
alquilado 	hired out (luigita)
alquilar 	let (ludoni); hire (lui); let, rent out (luigi)
alrededores 	environment, environs, surroundings (?irka?a?o)
alrededor de 	about, round, around, towards (?irka?)
altar 	altar (altaro)
alternar 	alternate (alterni)
alternativa 	alternation (alternado)
altitud 	altitude, height (alto)
alto 	contralto, contralto voice (aldo); high, lofty, tall (alta); loud (la?ta)
altura 	height (alteco)
alumbrado 	lighting (lumigo)
alumbrar 	illuminate, light (lumigi)
alumbre 	alum (aluno)
aluminio 	aluminium, aluminum (aluminio)
al amanecer 	at daybreak (tagi?e)
al contrario 	reverse, reversed (inversa)
al dorso 	at the back (dorse); behind (malanta?e)
al fin 	at last, finally, ultimately (fine)
al la derecha 	on the right (dekstre)
al menos 	atleast (almena?)
al mismo tiempo 	at the sametime (samtempe)
al norte de 	above (nordede)
al presente 	currently, nowadays, these days (nuntempe)
al principio 	first, firstly, first of all (unue)
amable 	affable, friendly, good ? n a t u r e d, kind (afabla); dainty, kind, nice, pretty (amabla); lovable (aminda)
amainar 	abate, weaken (malforti?i); abate, decrease, diminish, drop, fall (malplii?i)
amanecer 	dawn, daybreak (tagi?o)
amar 	love (ami)
amargo 	acerbic, bitter (amara)
amarillo 	yellow (flava); yellow (flavo)
amarradero 	landing ? s t a g e, pier (albordi?ejo)
amasadura 	massage (masa?o)
amazona 	Amazon (amazono)
ambos 	both (amba?)
amenaza 	menace, threat (minaco)
amenazar 	menace, threaten (minaci)
americana 	jacket (jako); Americanwoman (usonanino)
americano 	American (amerika); American (amerikano); American (usona); American, UScitizen (usonano)
amerindio 	Indian, AmericanIndian (indiano)
amianto 	asbestos (asbesto)
amiga 	friend (amikino)
amigo 	friend (amiko)
amistad 	friendship (amikeco)
amo 	boss, chief, leader (estro); chief, boss (?efo)
amojonar 	mark out, trace, trace out (limdifini)
amor 	affection, love (amo)
amortiguador 	shock ? a b s o r b e r (skusorbilo)
amortizar 	amortize, deaden (amortizi); payoff, redeem (elpagi)
ampolla 	bulb (ampolo); blister (blazo); blister (ha?tveziketo)
amputar 	amputate (amputi)
anales 	annals (analoj)
analfabeto 	illiterate (analfabeto)
anatema 	anathema, ban, excommunication (anatemo); anathema, ban, excommunication (ekskomuniko)
ancas de rana 	frog ' s l e g s (ranfemuroj)
anchas 	comfort (komforto)
ancho 	broad (lar?a)
anchoa 	anchovy (an?ovo)
anchura 	width (lar?eco); width (lar?o)
anciano 	old (maljuna)
ancla 	anchor (ankro)
anclar 	anchor (ankrumi)
andar 	march, walk (mar?i)
andas 	litter, st rec her (portilo)
anexar 	annex (aneksi)
anexionar 	annex (aneksi)
anguila 	eel (angilo)
angustia 	agony, anguish, fear (angoro); fright (timego)
angustioso 	afraid, fearful (timigita)
anillo 	ring (ringo)
animal 	animal (animalo); animal, beast (besto)
animar 	encourage, impel, instigate, spur on, stimulate, urge (instigi); encourage (kura?igi); cheer, fire, inspire, stimulate (plifervorigi); fan, fire, inspire, stimulate, stir up, urge on (plivigligi); rouse, stimulate, stir up (stimuli)
ano 	anus, arse (anuso)
anoche 	last night (hiera?vespere)
anonchecer 	dusk (duonlumo)
anormal 	abnormal (abnorma); abnormal (anormala); abnormal (nenorma); abnormal (nenormala)
anotar 	note, make a note, write down (noti)
anteayer 	the day before yesterday (anta?hiera?)
antebrazo 	lower ? a r m (anta?brako)
antecedente 	antecedent (anta?a?o); antecedent (antecedento)
antena 	aerial, antenna (anteno)
anteriormente 	ahead, formerly, previously (anta?e)
antes 	before, in front of (anta?); first, firstly, first of all (unue)
antes de que 	before, previous to (anta?ol)
anticongelante 	antifreeze (kontra?frosta?o)
antideslizante 	non ? s k i d (kontra??ora)
antiguo 	ancient, antique (antikva)
anualidad 	instalment, repayment (anuitato)
anualmente 	annual, yearly (?iujara)
anudar 	tie on (kuniginode)
anular 	cancel, countermand (malmendi); abjure, abolish, abrogate, annul, cancel, remit (nuligi)
anunciar 	advertise, announce, give notice (anonci); advise, counsel, notify (avizi)
anuncio 	announcement, notification, notice (anoncado); ad, advertisement (anonco); notification, notice (avizo)
anzuelo 	hook (fi?hoko)
apagar 	extinguish, put out (estingi)
aparador 	chest, dresser (komodo)
aparador de cocina 	dresser (kuirejstablo)
aparato 	apparatus, device, set (aparato)
aparato para sordos 	hearing aid (a?dilo); hearing aid (fonoforo)
aparcamiento 	parking garage (parkadgara?o); carpark, lay ? b y, parking bay, parking garage, parking place (parkejo)
aparcamiento de taxis 	cab ? s t a n d (taksistacio)
aparecer 	appear, emerge, perform (aperi)
apariencia 	appearance (?ajno)
apartado 	paragraph (alineo); remote (izolita)
apartamento 	apartment, flat (apartamento)
apartar 	divide, separate (apartigi); turn away (forturni)
aparte 	apart, particular, separate, special (aparta); apart, separately (aparte)
apellido 	surname (familianomo)
apenas 	barely, hardly, only just, scarcely (apena?)
aperitivo 	dram, nip, peg, snifter, snort er (aperitivo)
apestar 	reek, smell, smell bad, stink (fetori)
apetito 	appetite (apetito)
apio 	celery (celerio); turnip ? r o o t e d c e l e r y (tubercelerio)
aplaudir 	acclaim, applaud, clap (apla?di)
aplauso 	acclaim, acclamation, approval (apla?do)
aporrear 	thrash (bategi)
apostar 	bet, wager (veti)
apostatar 	a post at ize (apostati?i)
apoyarse 	lean (apogisin)
aprender 	learn (lerni)
apresurarse 	go fast, hurry, rush (rapidi); hurry, rush (ur?i?i); hurry (ur?isin)
apretar 	press, oppress, squeeze (premi); fasten, tighten, turn, turn on (turniplipreme)
aprovechar 	avail (utili); make use of, turn to good account, utilize (utiligi)
aprovecharse 	profit (profiti)
aprovisionamiento 	arrival, arrivals, supply (alportado); arrival, arrivals, supply (provizado)
aproximarse 	advance, come close, come closer, come on (alproksimi?i)
apuntar 	note, make a note, write down (noti)
arabesco 	arabesque (arabesko)
arado 	plough (plugilo)
arbusto 	bush, shrub (arbusto)
arca 	ark (arkeo); box, chest (kesto)
archi? 	arch ?, chief ? (?ef?)
archiduque 	archduke (?efduko)
archivero 	archivist, keeper of the records (ar?ivisto)
archivista 	archivist, keeper of the records (ar?ivisto)
archivo 	archive, archives, files, records (ar?ivo)
arcilla 	clay (argilo)
arco iris 	rainbow (?ielarko)
arder 	burn (bruli)
ardilla 	squirrel (sciuro)
arena 	arena (areno); s and (sablo)
arenas movedizas 	quicksand, quicksands (dronmar?ejo); quicksand, quicksands (movsablo)
arenque 	herring (haringo)
arenque ahumado 	red herring (fuma?itaharingo)
argelina 	Algerianwoman (al?erianino)
argelino 	Algerian (al?eria); Algerian (al?eriano)
argentina 	Argentinianwoman (argentinanino)
argentino 	Argentine, Argentinean (argentina); Argentine (argentinano)
argumento 	argument, plea (argumento)
arma 	weapon (armilo)
armar 	arm (armi)
armario 	cabinet, closet, cupboard, sideboard (?ranko)
armario para libros 	bookcase (libro?ranko)
armario ropero 	clothes ? p r e s s, wardrobe (vesto?ranko)
arquitecto 	architect (ar?itekto)
arrancar 	pick, pluck, tear off (de?iri); put on, start, switch on, turn on (ekfunkciigi); start running (ekkuri); extort, wrest, wring (eldevigi); abstract, take away (forpreni); start (startigi)
arranque 	run (ekkuro)
arreglar 	arrange, put in order, tidy (ordigi)
arreglo 	accommodation, adjustment, arrangement (aran?o); accommodation, accord, agreement (interkonsento)
arrendar 	hire (lui)
arrepentimiento 	repentance (pento)
arrestar 	arrest (aresti)
arresto 	apprehension, arrest, detention (arestado); apprehension, arrest, detention (aresto)
arriba 	above, on top, overhead, upstairs (supre)
arriesgado 	adventurous, hazardous, risky (riska)
arriesgar 	hazard, risk, venture (riski)
arroba 	at per s and, commercial ? a t s i g n, snail (volvitaA)
arrodillarse 	kneel (genui); kneel (genui?i); kneel (surgenui); kneel (surgenui?i)
arrogante 	arrogant (aroga); arrogant (aroganta); arrogant (malmodesta); arrogant (pretendema)
arrojar 	result (rezulti)
arromar 	blunt (malakrigi)
arroyo 	stream (rivereto)
arroz 	rice (rizo)
arruinar 	ruin (ruinigi)
arrurruz 	curry (kareo)
arte 	art (arto)
arteria 	artery (arterio)
artificial 	artificial (artefarita)
artillero 	artillery man, gunner (artileriano); artillery man, gunner (artileriisto)
artista 	artist (artisto)
arzo? 	arch ?, chief ? (?ef?)
arzobispado 	archbishopric (?efepiskoplando)
arzobispo 	archbishop (metropolito); archbishop (?efepiskopo)
as 	ace (aso)
asado 	roasted (rostita)
asalter 	assault, violate (atenci)
asar 	roast, toast (rosti)
ascender 	ascend, climb, scale (surgrimpi)
ascender a 	amount to (sumi?ije)
ascensor 	elevator, lift (lifto)
asediar 	besiege (sie?i)
asedio 	siege (sie?o)
asegurador 	insurer (asekuristo)
asegurar 	in sure (asekuri); affirm, assure (certigi)
asentir 	affirm, assent, say yes (jesi)
asfalto 	asphalt (asfalto)
asiento 	seat (sidejo)
asilo 	asylum (azilo)
asir 	clutch, grab, grasp, grip, seize (ekkapti); clutch, grapple (ekteni); capture, catch, grapple (kapti)
asistencias 	alimony (alimento)
asistente 	aid, assistant, helper (asistanto)
asma 	asthma, shortness of breath, whe e zines s (astmo)
asombrar 	amaze (mirigi)
asombrarse 	marvel, marvel at, wonder (miri)
aspecto 	appearance, aspect, look, sight, view (aspekto); exterior (ekstera?o)
aspirina 	aspirin (aspirino)
aster 	aster (astero)
astilla 	splinter (lignero); splinter (splito)
astronauta 	astronaut, spaceman (astrona?to)
astucia 	snare (insido); craft, craftiness, cunning, guile (malico)
astuto 	insidious (insida); malicious, mischievous, nasty, vicious (malica)
asumir 	guess, presume, suppose, surmise (supozi)
asunto 	affair, business, business deal, case, matter (afero)
atacador 	aggressor, assailant, attacker (atakanto)
atacar 	commit aggression (agresi); assault, attack (ataki)
ataque 	access, aggression, attack (atako); assault (atenco)
atender 	advert, pay attention, pay attention to, watch out for (atenti)
atender a 	advert, pay attention, pay attention to, watch out for (atenti); look after (prizorgi)
atentado 	assault (atenco)
atento 	attentive (atenta); attentive (atentema)
aterrizaje 	landing (surteri?o)
aterrizar 	land (surteri?i)
atleta 	athlete (atleto)
atletismo 	athletics (atletiko)
atornillar 	screw (?ra?bi)
atracar 	land (albordi?i)
atractivo 	attractive (alloga)
atraer 	attract, draw (allogi); attract (altiri)
atrasado 	backward, mentally deficient, retarded (mensepostrestanta)
atrasarse 	be late (malfrui)
atrasos 	arrears (postrestapozicio)
atravesar 	cross, go beyond, transfer (transiri); go beyond (transpasi)
atrayente 	attractive (alloga)
atreverse 	be bold, dare (kura?i)
atropallamiento 	collision (kolizio)
atropellar 	collide, run (alveturi)
aturdir 	drug (narkoti); drug, intoxicate, stun, stupefy (svenigi)
audiencia 	audience (a?dienco)
aula magna 	auditorium (a?lo)
aumentar 	accrue, grow (kreski); increase, freshen (pliforti?i); accrue, increase (pligrandi?i)
aumento 	accretion, growth (kresko)
aunque 	though, although (kvankam)
ausencia 	absence (foresto)
ausente 	absent (foresta); absent (forestanta); absent (mankanta)
australiano 	Australian (a?straliano)
austriaco 	Austrian (a?stra); Austrian (a?stro)
autoestrada 	motor road, motorway (a?tostrado); motor road, motorway (a?to?oseo)
autopista 	motor road, motorway (a?tostrado); motor road, motorway (a?to?oseo)
autor 	author (a?toro); author, writer (verkisto)
autoridad 	authority (a?toritato)
avalancha 	avalanche (lavango)
ave 	bird (birdo)
avellana 	hazelnut (avelo)
avena 	oats (aveno)
avenida 	avenue (aleo)
aventajar 	exceed, surpass (superi)
aventura 	adventure (aventuro)
aventurero 	adventurous (aventura); adventurous (aventurema); adventurer (aventuristo)
avergonzarse 	be ashamed (honti)
averia 	brake down (paneo)
aves 	birds (birdaro); fowl, poultry (birda?o)
avestruz 	ostrich (struto)
avisar 	caution, warn (averti)
aviso 	warning (averto); notification, notice (avizo)
avispa 	wasp (vespo)
axioma 	axiom (aksiomo)
ay 	ah, oh, ow (a?); woe (ve)
ayer 	yesterday (hiera?)
ayuda 	aid, help (asisto); aid, help (helpo)
ayudante 	adjutant, aide ? d e ? c a m p (adjutanto); aid, assistant, helper (asistanto)
ayudar 	accomodate, aid, assist, help (helpi)
ayunar 	fast (fasti)
ayuntamiento 	town ? h a l l (magistratadomo); city hall, town hall (urbdomo)
azada 	hoe (sarkilo)
azafata 	stewardess (stevardino)
azteca 	Aztec (asteka)
azucarero 	sugar ? b o w l, sugar bowl (sukerujo)
azul 	blue (blua); sky blue (lazuro)
azulejo 	tile (kahelo)
a bordo 	aboard (en?ipi?inta)
a cuadros 	checked, chequered (kvadratita)
a eso de 	about, approximately (proksimume)
a instancias de 	at the instance of (la?insistode)
a la cubana 	in the C u b a n w a y (kube)
a la izquierda 	on the left (maldekstre)
a lo largo de 	along (la?longede); through (tra)
a lo menos 	atleast (almena?); atleast (minimume)
a menudo 	frequently, often, regularly (ofte)
a que 	until, till (?is)
a saber 	that is (tioestas)
a su salud 	cheers, good health (jeviasano)
a tiempo 	at the right time, in time (?ustatempe)
a veces 	several times, sometimes (kelkfoje)
babero 	bib (salivtuketo)
babor 	portside (babordo)
babosa 	slug (limako)
bacalao 	cod, codfish (moruo)
bache 	pole (foso); cavity (kava?o); cave, cavity (kavo)
bacteria 	bacterium (bakterio)
badajo 	clapper (sonormartelo)
bagatela 	trifle (bagatelo)
bagazo 	bag asse (bagaso)
bailar 	dance (danci)
baile 	ball, dance (balo); dance (danco)
baja 	abatement (malplii?o); decay (ruini?o)
bajamar 	low tide (refluo)
bajar 	get out (elvagoni?i); descend, go down (mallevi?i); decrease, lower (malplialtigi); descend, get off, go down (malsupreniri); discount, rebate (rabati)
bajo 	bass, bass voice (baso); low (malalta)
bajorrelieve 	bas ? r e l i e f, low relief (bareliefo)
bala 	bale (pakego)
balance 	balance sheet (bilanco)
balancear 	rock, swing (balanci); balance, poise (balanci?i)
balanza 	scales (pesilo)
balaustrada 	balustrade, banisters, parapet, railing (balustrado)
baliza 	buoy (buo); beacon (gvidmarkilo)
ballena 	baleen, whalebone (balenlameno); whale (baleno); baleen, whalebone (balenosto); bus k, steel (barto)
ballet 	ballet (baledo)
balneario 	spa (banurbo)
baloncesto 	basketball (basketbalo)
balotaje 	ballot, balloting, voting by ballot (balotado)
bancarrota quiebra 	bankruptcy, failure (bankroto)
banco 	bank (banko); bench (benko)
bandeja 	tray (pleto)
bandera 	banner, flag (flago); flag, standard (standardo)
bandido 	band it (bandito)
banquero 	banker, bank manager (bankestro)
banquete 	banquet (bankedo); banquet, feast (festeno)
bar 	buffet (bufedo); bar, pub (trinkejo)
barato 	cheap, inexpensive (malkara)
barba 	beard (barbo); chin (mentono)
barbero 	barber (barbiro); barber (barbisto); barber (razisto)
barco 	bark, barque (barko); boat (boato); ship, vessel (?ipo)
barco de remos 	row ? b o a t, rowing ? b o a t (remboato)
barco de vapor 	steamship (vapor?ipo)
barman 	barman, bartender (trinkejaservisto)
baronesa 	baroness (baronino)
barraca 	barrack, barn, shack, shanty, shed (barako)
barra de chocolate 	bar of chocolate (?okoladbriketo)
barrena 	bore (borilo)
barrendero 	sweeper (glacibalaisto)
barrer 	sweep (balai)
barricada 	barricade (barikado)
barrio 	district, neighbourhood, quarter (kvartalo)
barrio bajo 	backstreet, slum (kvartala?o)
barro 	mud (koto)
basalto 	basalt, whim stone (bazalto)
basar 	base (bazi)
bastante 	a little, rather, some, somewhat, to some extent (iom); rather (meze); enough, sufficient (sufi?a); enough, quite, rather, sufficiently (sufi?e)
bastar 	suffice (sufi?i)
bastardo 	bastard (bastardo)
bastidor 	flat (kuliso)
basurero 	dump, refused ump, tip, rubbish tip (defala?ejo); dump, refused ump, tip, rubbish tip (resta?ejo)
bata 	batalla 	action, battle, scuffle, struggle (batalo)
batata 	sweet potato, yam (batato)
batista 	bat iste, cambric, lawn (batisto)
baya 	berry (bero)
bayeta 	baize (krudlan?tofo)
bazar 	bazaar, fair, market (bazaro); bazaar (?iovendejo)
beber 	drink (trinki)
bebida 	beverage, drink (trinka?o)
beige 	beige (flavgriza)
belga 	Belgian (belga); Belgian, Belgianwoman (belgino); Belgian (belgo)
belleza 	beauty (beleco)
bencina 	gasolene, gasoline, petrol (benzino)
besar 	kiss (kisi)
beso 	kiss (kiso)
bestia 	animal, beast (besto)
bestial 	beastly, bestial (besteca)
biblioteca 	library (biblioteko)
bicarbonato 	bicarbonate of soda (natriabikarbonato)
bicicleta 	bien 	okay, well (bone)
bienvenida 	welcome (bonvenon)
bife 	steak, beefsteak (bifsteko)
biftec 	steak, beefsteak (bifsteko)
bigoti 	moustache (liphararo)
bilis 	bile, gall (galo)
billete 	bill, ticket, note (bileto)
billete del tren 	railway ticket, train ticket (trajnbileto)
billete de banco 	bank ? n o t e (monbileto)
billete de entrada 	admission ticket (enirbileto)
billete de equipaje 	luggage ticket (paka?bileto)
billete de ida y vuelta 	return ? t i c k e t (irorevenabileto)
billete de viaje 	ticket (veturbileto)
biquini 	bikini (bikino)
birrete 	beret (bireto); cap (?apo)
bisnieta 	great granddaughter (pranepino)
bisnieto 	great grandson (pranepo)
bistec 	steak, beefsteak (bifsteko)
bizcocho 	bic u it (biskoto); biscuit, cookie (biskvito)
blanco 	bloc de notas 	notepad (leterbloko); notepad (notbloko); notepad (notfoliaro)
bloque 	block, pad (bloko)
blusa 	blouse (bluzo)
boca 	bocadillo 	roll (bulko); sandwich (sandvi?o)
boca arriba 	backward, on one ' s b a c k (dorsen); backwards (posten)
bocina 	boda 	wedding, wedding ? p a r t y (edzi?afesto); wedding, wedding ? p a r t y (geedzi?afesto)
boina 	beret (vaska?apo)
bola 	chunk, clod, lump (bulo); bullet (kuglo)
bolsa 	hand ? b a g (mansako)
bolsa de trabajo 	employment exchange, labor exchange, labour exchange (dungperejo)
bolsa para bicicletas 	cycle ? b a g (biciklosako)
bomba 	bomb (bombo); pump (pumpilo)
bomba incendiaria 	incendiary bomb (brulbombo)
bondad 	goodness (boneco)
boniato 	sweet potato, yam (batato)
bonito 	affable, friendly, good ? n a t u r e d, kind (afabla); beautiful, fine, handsome, lovely (bela); nice (boneta); delightful, lovely (rava); charming, lovely (?arma)
borde 	borracho 	drunk, intoxicated (ebria)
bosque 	forest, woods (arbaro)
bota 	boot (boto)
botella 	bottle (botelo)
botella de gas 	gas cann is ter, gas cylinder (gasbotelo)
botica 	chemist ' s s h o p, drugstore (apoteko)
boticario 	chemist (apotekisto)
boxeador 	boxer (boksisto)
boya 	buoy (buo)
braguitas 	briefs (kalsoneto)
branquia 	gill (branko)
bravo 	brave, courageous, valiant (kura?a)
brazalete 	bracelet (braceleto); bracelet (?irka?brako)
brazo 	brema 	brezal 	heath (erikejo)
brillar 	shine (brili)
britano 	Briton (brito)
brocha de afeitar 	shaving ? b r u s h (razpeniko)
broma 	gag, joke (?erco)
bromear 	jest, joke (?erci)
bronco 	abrupt (bruska); brutal, gruff, harsh, rough, sour, surly, unkind, unpleasant (malafabla)
brumoso 	fuzzy, misty (nebula)
brusco 	abrupt (bruska)
brusko 	brutal, gruff, harsh, rough, sour, surly, unkind, unpleasant (malafabla)
bucear 	dive, plunge (plon?i); dive, sink (subakvi?i)
buenas noches 	goodnight (bonannokton)
buenas tardes 	good evening (bonanvesperon)
bueno 	good, nice, okay (bona)
buey 	ox (okso)
buho 	owl (strigo)
bula 	indulgence (indulgenco)
burdel 	brothel (bordelo)
burla 	gag, joke (?erco)
burro 	as s, donkey (azeno)
buscar 	fetch, get, pickup (irpreni); get, lay hold of, pickup, take (preni); look for, seek (ser?i)
butaca 	armchair (brakse?o)
cabal 	absolute, complete (kompleta); entire, overall, whole (tuta)
caballero 	caballo 	horse (?evalo)
caballos 	horsepower (?evalforto); horsepower (?evalpovo)
caballo padre 	stallion (vir?evalo)
cabana 	cabin, hut, shack (kabano)
cabeza 	cabina 	bathing box (banbudo); bathing box (bankajuto); barn, shed, stand (budo)
cable 	cable (kablo)
cable de remolque 	towing ? l i n e (trenkablo)
cabra 	goat (kapro)
cacahuete 	peanut (arakido)
cacao 	cocoa (kakao)
cacerola 	casserole, saucepan (kaserolo)
cacto 	cactus (kakto)
cada vez 	each time, everytime (?iufoje)
cadena 	chain (?eno)
cadena antideslizante 	non ? s k i d c h a i n (kontra?glita?eno)
cadera 	hip (kokso)
caer 	drop, fall (fali)
caer enfermo 	betaken ill, fall ill (malsani?i)
cafetera 	coffee ? p o t (kafkru?o); coffee ? p o t (kafujo)
caja 	cashier ' s s t a n d, fund, money box, money ? b o x, till (kaso); box, chest (kesto); box (skatolo); jug, box, container, vessel (ujo)
caja de cambios 	gear ? b o x, gear ? c a s e (rapidumskatolo); gear ? b o x, gear ? c a s e (rapidumujo)
cal 	lime (kalko)
calabaza 	calabash, gourd (kalabaso)
calamar 	sepia (sepio)
calcular 	calculate, count, figure, workout (kalkuli)
caldo 	bouillon (buljono)
calendario 	almanac (almanako)
calentar 	heat, stoke (hejti)
calidad 	property, quality (kvalito)
caliente 	warm (varma); hot (varmega)
callarse 	be quiet (silenti)
calle 	street (strato)
calleja 	alley, lane (strateto)
callo 	corn (kalo)
calmar 	appease, calm, quiet, soothe, still (trankviligi)
calmarse 	abate, subside (kvieti?i); calm down (trankvili?i)
calor 	heat (varmego)
calumniar 	slander (kalumnii)
calzador 	shoe ? h o r n, shoe ? l i f t (?ukorno)
calzoncillos 	drawers, panties, underpants (kalsono)
cama 	sleeping ? a c c o m o d a t i o n, sleeping ? p l a c e (dormejo); bed (lito)
camarera 	dressing ? g o w n (hejmvesto); waitress (kelnerino); dressing ? g o w n (negli?arobo)
camarero 	waiter (kelnero)
camarote 	cabin (kajuto)
cama de matrimonio 	double bed (dupersonalito)
cambiar 	alter, change (alii?i); interchange, swap (inter?an?i); vary (varii); change, turn (?an?i)
cambio 	variety (vario); change (?an?mono)
camello 	camel (kamelo)
camilla 	litter, st rec her (portilo)
camino 	path, road, way (irejo); road, route, way (vojo)
camino sin salida 	blind alley, cul ? d e ? s a c (sakvojo)
camisa 	shirt (?emizo)
camisa de deporte 	sports shirt (sport?emizo)
camiseta 	shirt (?emizo)
camita 	bedstead (litkadro)
camote 	sweet potato, yam (batato)
campamento 	camping ground, camping site (kampadejo); camp of tents, tented camp (tendaro)
campana 	hood, suction apparatus (desu?ilo)
campanilla 	bell (sonorilo); bell (tintilo); blister (veziketo)
campesino 	farmer (kampulo)
camping 	camping ground, camping site (kampadejo)
campo 	campo deportivo 	sports ground (sportejo)
campo santo 	cemetery, God'sacre, graveyard (tombejo)
canal 	canal, channel (kanalo)
canario 	Canary (kanaria)
candelero 	candlestick (kandelingo)
cangrejo 	crayfish (kankro); crab (krabo)
cansado 	tired (laca)
cansar 	fag out, jade, overdrive, override (lacegigi)
cantar 	sing (kanti)
cantidad 	quantity (kvanto); amount, sum (sumo)
cantor 	singer (kantisto)
cantora 	singer, female singer (kantistino)
caos 	chaos, tangle (?aoso)
capacidad 	ability (kapableco); ability, capability, fitness, suitability (ta?geco)
capaz 	able, capable (kapabla)
capital 	capital (kapitalo); metropolis (metropolo); capital, capital city, metropolis (?efurbo)
capitanear 	govern, head up, restrain (estri); command, be in command, order (komandi)
capitular 	capitulate, surrender (kapitulaci)
capot 	bonnet, hood (kapoto)
cara 	face (viza?o)
caracol 	snail (heliko)
carburador 	car bure tt or (karburilo)
cardo 	this le (kardo)
carga 	burden, charge, load (?ar?o)
cargar 	burden, load (?ar?i)
cargo 	acc us al, accusation (akuzo); accusation (denunco); function (funkcio); acc us al, accusation, charge, complaint, indictment (kulpigo); function, job, office, post (ofico)
carnada 	bait (loga?o)
carnaval 	carnival (karnavalo)
carne 	flesh (karno); meat (viando)
carnero 	ram, t up (vir?afo); mutton (?afa?o)
carnestolendas 	carnival (karnavalo)
carnet 	notebook (notlibro); attempt, test (provo)
carnet de conducir 	driving ? l i c e n c e (kondukpermesilo)
carne de cerdo 	pork (porka?o)
carne de cordero 	lamb (?afida?o)
carne de ternera 	veal (bovida?o)
carne de vaca 	beef (bova?o)
carne picada 	minced meat (viandhaketa?o)
carne salada 	salt meat, salted meat (peklitaviando)
carnicero 	butcher (bu?isto)
caro 	carrera 	career (kariero)
carrete 	film (filmruleto)
carretera 	motor road, motorway (a?tostrado); motor road, motorway (a?to?oseo)
carretera principal 	major road (prioritatavojo); major road (?efvojo)
carretera resbaladiza 	danger of skidding (jordan?ero)
carretera secundaria 	by ? w a y, side ? w a y (flankvojo)
carrete de rueda 	hub, nave (nabo)
carro 	cart, chariot (?aro)
carta 	letter (letero)
cartearse 	correspond (korespondi)
cartel 	notice, placard, poster (afi?o)
cartera 	wallet (monbiletujo); briefcase, file (teko)
cartero 	postman (leterportisto)
casa 	casada 	married (edzini?inta)
casado 	married (edzi?inta)
casarse 	marry, be married, get married (edzini?i); marry, be married, get married (edzi?i); marry, be married, get married (geedzi?i)
cascada 	waterfall (akvofalo); waterfall (kaskado)
cascajo 	broken stones, chipping s, road ? m e t a l, rubble, stone ? c h i p p i n g s (?tonetaro)
casi 	almost, nearly (preska?)
caso 	caspa 	dandruff (kapha?teroj)
castellano 	Castillian (kastila)
castigar 	punish (puni)
castigo 	redemption (amortizo); punishment (puno)
castillo 	castle (kastelo)
castor 	beaver (kastoro)
catecismo 	catechism (kate?ismo)
catedral 	cathedral (katedralo)
catorce 	fourteen (dekkvar)
cauce 	bed, watercourse (fluejo)
caucho 	rubber (ka??uko)
caudillo 	boss, chief, leader (estro); chief, boss (?efo)
causa 	cause, reason (ka?zo)
causar 	activate, cause, give rise to (ka?zi)
cavar 	dig, grub, spade (fosi)
cazar 	chase, hunt (?asi)
cebada 	barley (hordeo)
cebo 	bait (loga?o)
cebolla 	onion (cepo)
cebollana 	chive (?enoprazo)
ceder 	cede, give in, give up, give way, relinquish, yield (cedi)
ceja 	brow, eyebrow (brovo)
celebrar 	celebrate (celebri)
celebrar una fiesta 	celebrate (festi)
celo 	fervor, fer v our, zeal (fervoro)
cementerio 	cemetery, God'sacre, graveyard (tombejo)
cena 	dinner, midday meal (tagman?o); evening meal, supper (vesperman?o)
cenicero 	ashtray (cindrujo)
ceniciento 	ashen (cindrogriza)
ceniza 	ash, cinder (cindro)
censura 	censor (cenzuro); criticism (kritiko); observation, remark, reproof (malla?do); observation, remark (ripro?arimarko)
censurable 	blameworthy, c en sur able, condemn able, objectionable (malaprobinda)
censurar 	censor (cenzuri); censure, criticize (kritiki); reproach, rebuke, reprove, scold (malla?di)
centeno 	rye (sekalo)
central 	central (centra)
centro 	centre (centro); average, mean, middle (mezo)
cepillar 	brush (brosi)
cepillo 	brush (broso); plane (rabotilo)
cepillo de dientes 	tooth ? b r u s h (dentbroso)
cerca 	close, near, nearby (proksime)
cercar 	bar, obstruct (bari)
cerca de 	at, beside, by, near, nearby, near to, next to (apud); about, approximately (proksimume)
cerda 	sow (porkino)
cerdo 	hog, pig, swine (porko); boar (virporko)
cerebro 	brain (cerbo)
ceremonia 	ceremony (ceremonio); ceremony (solena?o)
cereso 	cherry ? t r e e (?erizujo)
cereza 	cherry (?erizo)
cero 	nought, zero (nul)
cerrado 	closed, shut (fermita)
cerradura 	lock (seruro)
cerrar 	close, shut (fermi); lock (?losi)
certificado 	certificar 	record, register (registri)
cerveza 	ale, beer (biero)
cesto 	basket (korbo)
chal 	shawl (?alo)
chaleco 	vest, waistcoat (ve?to)
chanza 	gag, joke (?erco)
chaqueta 	jacket (jako)
charco 	pool (akvotruo)
charlar 	chat, chatter (babili)
chauffeur 	chauffeur, driver (?oforo)
checo 	Czech (?e?a); Czech (?e?o)
cheque 	check, cheque (?eko)
chicle 	chewing ? g u m (ma?gumo)
chico 	boy, lad, laddie (knabo); diminutive, little, small (malgranda)
chilena 	Chileanwoman (?ilianino)
chileno 	Chilean (?ilia); Chilean (?iliano)
chino 	Chinese (?ina); Chinaman, Chinese (?ino)
chispa 	spark (fajrero); spark (sparko)
chocar kun 	collide with, crash into (koliziikun)
chocolate 	chocolate (?okolado)
choque 	collision (kolizio)
chuleta 	cutlet (kotleto)
chupar 	suck (su?i)
ciclo 	ciclomotor 	moped (mopedo)
ciego 	blind (blinda)
cielo 	heaven, sky (?ielo)
ciencia 	science (scienco)
ciento 	hundred, one hundred (cent)
ciertamente 	certainly (certe)
cierto 	certain, sure (certa); a, any, anybody, some, somebody, one, someone, someone (iu)
cifra 	cipher, digit, figure, numeral (cifero)
cigarillo 	cigarette (cigaredo)
cigarro 	cigar (cigaro)
cilindro 	cylinder, roller (cilindro)
cincel 	chisel (?izilo)
cinco 	five (kvin)
cine 	cinema, movie theatre (kinejo)
cinta 	bond, tie (ligilo); connection, league (ligo); ribbon (rubando)
cinta pegante 	adhesive tape (glubendo)
cinto 	cintura 	waist, waistline (talio)
circo 	circus (cirko)
circuito 	circuit (cirkvito)
circular 	circular (cirkulero)
circunspecto 	thoughtful (anta?zorga); careful, cautious (singarda); careful, cautious (singardema); careful, cautious (singardema)
ciruela 	plum (pruno)
cirujano 	surgeon (?irurgo)
cita 	citation, quotation (cita?o); appointment, date, rendezvous (rendevuo)
citar 	cite, quote (citi)
ciudad 	city, town (urbo)
ciudadela 	citadel (citadelo)
civil 	civil, civilian, non ? m i l i t a r y (civila)
cizalla para setos 	hedge clippers, hedges hears (he?tondilo)
claro 	bright, clear, light (hela); clear, distinct, plain (klara)
clase 	class (klaso); kind, sort (speco)
clasificar 	classify (enklasigi)
clavel 	carnation, pink (dianto)
clavo 	nail (najlo)
cliente 	buyer, client, purchaser (a?etanto); client, customer (kliento)
clientela 	clima 	climate (klimato)
cloaca 	sewer (kloako)
cloro 	chlorine (kloro)
club 	club, society (klubo)
coartada 	alibi (alibio)
cobertizo 	penthouse, shed (alero); penthouse, shed (anta?tegmento); barrack, barn, shack, shanty, shed (barako); penthouse, shed (markezo)
cobrador 	guard (konduktoro)
cobre 	copper (kupro)
cocer 	bake (baki)
coche?cama 	sleeping ? c a r (litvagono)
coche 	car (a?to); carriage, coach (kale?o); carriage, coach, railway carriage, wag gon (vagono)
coche remolque 	trailer (postveturilo)
cochina 	sow (porkino)
cochinillo 	piglet (porkido)
cocina 	kitchen (kuirejo)
cocinar 	cook (kuiri)
cocinera 	cook, female cook (kuiristino)
cocinero 	cook, male cook (kuiristo)
cocodrilo 	crocodile (krokodilo)
codiciar 	covet (avidi)
codicioso 	acquisitive, eager, greedy (avida)
codo 	elbow (kubuto)
coger 	clutch, grab, grasp, grip, seize (ekkapti); clutch, grapple (ekteni); fetch, get, pickup (irpreni); capture, catch, grapple (kapti); get, lay hold of, pickup, take (preni)
cohete 	rocket (raketo)
cojear 	limp (lami)
cojo 	lame (lama)
col 	cabbage (brasiko)
cola 	glue (glua?o); glue (gluo); tail (vosto)
colcha de cama 	bedspread, counterpane, coverlet (litasuperkovrilo)
colecta 	collection (kolektado)
colega 	colleague (kolego); colleague (samprofesiano)
colegio 	college (kolegio)
coles de Bruselas 	Brussels?sprouts (bruselabrasiko)
colgar 	droop, hang (pendi); hang (pendigi)
coliflor 	cauliflower (florbrasiko)
colina 	hill (monteto)
colocar 	invest (investi); lay (ku?igi); lay down, place, put, put down (meti)
colonia 	colony, settlement (kolonio)
color 	colour, dye (koloro)
columna 	column, pillar (kolono)
comadrona 	nurse, dry ? n u r s e, monthly nurse (vindistino)
comandante 	boss, chief, leader (estro); commander (komandanto); chief, boss (?efo)
comarca 	region (regiono)
combiar 	change (?an?i?i)
comedor 	dining ? r o o m (man?ejo); dining ? r o o m (man?o?ambro)
comenzar 	begin, commence, start (komenci); begin, commence, start (komenci?i)
comer 	lunch (meztagman?i)
comerciante 	merchant (komercisto); businessman, merchant (negocisto)
comercio 	business, commerce, trade (komerco)
comerse 	eat up (forman?i)
comestible 	edible (man?ebla)
comestibles 	food (man?a?o)
cometer 	achieve, act, do, make, perform (fari); accomplish, achieve, keep, observe, perform (plenumi)
comida 	meal (man?o); dinner, midday meal (tagman?o)
comienzo 	beginning, commencement, start (komenci?o); beginning, commencement, start (komenco)
comitiva 	procession (procesio)
como 	como es debido 	decently, properly (dece)
como si 	as if, as though, in away (kvaza?)
compadecer a 	have compassion on, pity (kompati)
comparar 	compare (kompari)
compartir 	divide, separate, share (dividi)
compensar 	compensate (kompensi)
competencia 	competition (konkurenco)
competidor 	rival (rivalo)
competir 	compete, rival (konkuri)
complacer 	meet with, satisfy (kontentigi)
complekso 	complex (komplekso)
completamente 	completely, entirely, through (komplete); completely, fully (plene)
completar 	complete (kompletigi)
completo 	absolute, complete (kompleta); entire, overall, whole (tuta)
componerse 	consist of (konsistiel)
compositor 	composer (komponisto)
compra 	accession, acquisition, asset (akiro); acquisition, purchase (a?etado)
comprador 	buyer, client, purchaser (a?etanto); client, customer (kliento)
comprender 	understand, realize (kompreni)
comprendido 	understood (komprenita)
comprensible 	understandable (komprenebla)
compromiso 	accommodation (kompromiso)
computador 	computer (komputero)
computar 	calculate, count, figure, workout (kalkuli)
comunicar 	communicate, report (komuniki); connect, connect up, plugin (konekti)
comunista 	communist (komunisto)
con 	with (kun)
concernir 	concern (koncerni)
concha 	shell (konko)
concierto 	concert (koncerto)
conciso 	concise (konciza)
concluir 	accomodate, end, finish, terminate (fini)
concurso 	competition, contest (konkurso)
condenar 	condemn, sentence (kondamni)
condom 	condom, rubber (kondomo)
conducir 	conduct, guide, lead (konduki); go, ride, travel (veturi)
conducirse 	behave, conduct oneself (konduti)
conejo 	rabbit (kuniklo)
conejo macho 	buck, buck ? r a b b i t (virkuniklo)
conferencia 	conference (konferenco)
confesar 	confianza 	confidence (konfido)
confirmar 	affirm, assent, say yes (jesi); acknowledge, confirm, corroborate (konfirmi)
confiscar 	confiscate (konfiski)
conflicto 	conflict (konflikto)
conforme 	agreed, okay (konsentite)
congreso 	congress, convention (kongreso)
conminar 	menace, threaten (minaci)
conmovedor 	affecting, moving, touching (emocia); affecting, moving, touching (kortu?a)
conmover 	move, stir (emocii); affect, agitate, move (kortu?i)
conmovido 	seized with emotion (emociita); seized with emotion (kortu?ita)
conocido 	famous (fama); famous (famkonata); acquaintance (konato)
conocimiento 	acquaintance, knowledge (kono)
conocimientos 	fame, renown (fameco)
conquistar 	conquer (konkeri)
consecuencia 	consequence, consistency (konsekvenco)
consecuente 	consistent (konsekvenca)
consecutivo 	following, next (sekvanta)
conseguir 	succeed (sukcesi)
consejero 	counsellor (konsilanto)
consejo 	advice, counsel (konsilo)
consentir 	spoil (trodorloti)
consequir 	achieve, acquire, attain, get, obtain (akiri)
conserje 	porter (pordisto)
conservador 	conservative (konservativa)
conservar 	conserve, keep, maintain, preserve (konservi)
conservatorio 	academy of music (konservatorio)
considerable 	considerable, sizable (konsiderinda)
considerar 	account, consider, esteem, regard, take into account (konsideri)
consolar 	comfort, console (konsoli)
constipado 	constipation (mallakso)
construir 	build, construct (konstrui)
consulado 	consulate (konsulejo)
consulta 	consultation (konsulto)
consumidor 	consumer (konsumanto)
consumir 	consume, use up (konsumi)
consumo 	demand, sale (debito)
contable 	book ? k e e p e r (librotenisto)
contacto 	contact (kontakto)
contagiado 	contaminated, infected (infektita)
contagiar 	infect (infekti); communicate (konta?i)
contagioso 	catching, contagious, infectious (infekta); catching, contagious, infectious (konta?a)
contante 	cash, in cash (kontanta)
contar 	count (nombri); narrate, relate, tell (rakonti)
contemplar 	account, consider, esteem, regard, take into account (konsideri)
contener 	bridle, check, restrain (bridi); comprise, contain, include (enhavi); control, govern, restrain, rule (regi)
contento 	contented, pleased, satisfied (kontenta)
contestar 	answer, reply, respond (respondi)
contestar a 	answer (respondial)
contiguo 	adjacent (apuda); adjacent, adjoining (limtu?anta); adjacent, nearby, neighbouring (najbara)
continuamente 	constantly, continually, continuously (da?re); all the time, ceaselessly (sen?ese)
continuar 	continue, hold, last (da?radi); continue, endure, keep on, last (da?ri); continue, goon, proceed with (da?rigi)
continuo 	abiding, lasting (da?ra); constant, continual, permanent, sustained (konstanta); lasting (kontinua); continuous (senhalta); continuous (seninterrompa); constant, lasting, sustained (sen?esa)
contra 	across from, against, in exchange for, opposed to, opposite, upon (kontra?)
contradecir 	contradict (kontra?diri)
contramandar 	cancel, countermand (malmendi); abjure, abolish, abrogate, annul, cancel, remit (nuligi)
contraste 	contrast (kontrasto)
contratar 	invite tenders for, put out to tender (adjudiki); make a contract (kontrakti)
contrato 	contract (kontrakto)
contribuyente 	rate payer, taxpayer (impostpaganto)
controlar 	audit, check, checkup on, supervise, verify (kontroli)
conulla 	inverted comma, quotation mark, quote (citilo)
conullas 	quotation marks, quotes (citiloj); inverted commas, quotation marks, quotes (citsignoj)
convencer 	convince, persuade (konvinki)
convenido 	agreed, okay (konsentite)
conveniente 	decent, fitting, proper, suitable (deca); appropriate, becoming, seemly, suitable (konvena)
convenio 	convenir 	befit, befitting (deci); agree (interkonsenti); be appropriate, suit, be suitable (konveni)
convento 	monastery (mona?ejo)
conversar 	converse (konversacii)
convertir 	convert (konverti)
con motivo de 	because of, on account of (ka?zede)
copa 	goblet (pokalo)
copia 	copy (kopio)
copiar 	copy (kopii); print (printi)
copla 	verse (strofo)
copo de nieve 	snowflake (ne?ero)
corbata 	tie, necktie (kravato)
corcho 	cork (korko)
cordel 	line (hokfadeno)
cordero 	lamb (?afido)
cordillera 	chain of mountains, mountain chain, mountain range, rand (monto?eno)
coronar 	crown (kroni)
correcto 	correct, right (korekta)
corregir 	correct (korekti)
correo 	mail, post (po?to)
correr 	flow (flui); race, run (kuregi); run (kuri)
corresponder al 	answer, answer to, come up to (estikonformaal); correspond to (estila?)
corriente 	current, flow, stream (fluo); current (kurento)
corromper 	spoil (malbonigi)
cortacircuito 	short circuit (fu?kontakto)
cortar 	cutoff (detran?i); pick, pluck, tear off (de?iri); behead, decapitate (senkapigi); clip, cut, shear (tondi); cut, slice (tran?i)
corteza 	bark (arbo?elo); bast (basto)
cortina 	curtain (kurteno)
corto 	short (kurta); brief, short (mallonga)
corzo 	roe (kapreolo)
cosa 	thing (a?o)
cosecha 	harvest (rikolto)
coser 	sew (kudri)
costa 	coast, seaside, shore (marbordo)
costar 	cost (kosti)
costear 	bear the cost of, defray the cost of, pay the expenses of (pagilakostojnde)
costumbre 	custom, habit, way (kutimo)
costura 	seam (junto); seam (kunkudro)
costurera 	tailor, female tailor (tajlorino)
crecer 	accrue, grow (kreski)
creer 	account, accredit, believe, deem (kredi); create (krei); think (pensi)
crema 	cream (kremo)
cremallera 	zipper (zipo)
crema para zapatos 	polish, wax (ciro)
crepe 	pancake (patkuko)
criada 	maid, servant (servistino); maid (?ambristino)
criado 	boy, servant (servisto)
crimen 	crime (krimo)
crisis 	crisis, depression, emergency (krizo)
cristianismo 	Christianity (kristaneco)
cristiano 	Christian (kristana); Christian (kristano)
criticar 	censure, criticize (kritiki); judge (priju?i)
cruce 	crossroads (vojkruci?o)
crudo 	crude, raw, rough (kruda); raw, uncooked (nekuirita)
cruz 	cross (kruco)
cuadra 	stable, stall, sty (stalo)
cuadro 	bed (bedo); painting, picture (pentra?o)
cuartel 	barracks (kazerno); barracks (soldatejo)
cuarto 	apartment, flat (apartamento); fourth (kvara); fourth (kvarono); chamber, room (?ambro)
cuatro 	four (kvar)
cubierta 	deck (ferdeko)
cubierto 	forks, knives and spoons (man?ilaro)
cubierto de verdor 	covered, grown over, overgrown (surkreskata)
cubo 	bucket, pail (sitelo)
cubrir 	cover (kovri)
cucaracha 	cockroach (blato)
cuchara 	spoon (kulero)
cuchichear 	whisper (flustri)
cuchillo 	knife (tran?ilo)
cuello 	neck (kolo); collar (kolumo)
cuenta 	account, bill, in voice (fakturo); account, bill, calculation (kalkulo); account (konto)
cuenta bancaria 	bank account, banking account (bankokonto)
cuerda 	cord, rope, string (?nuro)
cuerno 	cuero 	leather (ledo)
cuerpo 	body (korpo)
cuervo 	raven (korako)
cuesta 	acc liv it y, hillside, slope (deklivo)
cuesta abajo 	down the slope, downhill (montsuben)
cueva 	cave, grotto (groto); cave, cavern, den (kaverno)
cuidado 	care, concern (zorgo)
cuidar 	attend, nurse, tend to (flegi); care, see, take care, worry (zorgi)
cuidarse de 	care about, take care of (zorgipri)
cuidar de 	look after (prizorgi)
culpa 	blame, fault, guilt (kulpo)
culpable 	guilty (kulpa)
cultivar 	cultivate, grow (kulturi); plant (planti)
cultivo 	planting (plantado)
culto 	service, worship service (diservo)
cultura 	culture (kulturo)
cumplimiento 	replacement, replenishment, supplement (kompletigo); compliment (komplimento)
cuna 	cradle, place of birth (naski?ejo)
cuota 	dues, subscription (kotizo)
cura 	treatment (kuracado); pastor, vicar (paro?estro); clergyman, pastor, priest (pastro)
curar 	care for, cure, treat (kuraci); cure, heal, remedy (resanigi); cure, heal, remedy (sanigi)
curioso 	agog, curious, inquisitive (scivola)
cursillo 	class, course (kurso)
curso 	class, course (kurso); exchange rate, rate of exchange (kurzo)
curva 	bend, curve (kurbo)
curvar 	bend (fleksi); bend (kurbigi)
dado que 	supposing that (supozeke)
dama 	damas 	checkers (damludo); checkers (damoj)
dar 	give (doni)
darse de baja 	quit, resign (eksi?i)
darse tono 	attitudinize, pose, put on airs (afekti)
dar a destajo 	invite tenders for, put out to tender (adjudiki)
dar a la bomba 	pump (pumpi)
dar a luz 	bear, give birth to (naski)
dar dentelladas a 	snap at, snarl at, snub (ripro?imalafable)
dar de comer 	feed (man?igi)
dar gracias a 	thank (danki)
dar la bienvenida 	welcome (bonvenigi)
dar lugar a 	cause, cause to take place (okazigi)
dar parte de 	issue, proclaim (proklami)
de 	debajo de 	below, beneath, under, underneath (sub)
deber 	duty, obligation (devo); owe (?uldi)
debutante 	beginner (komencanto)
decadencia 	decay (ruini?o)
decentar 	cut into (ektran?i); begin, commence, start (komenci)
decidirse 	decide (decidi)
decir 	say, tell (diri)
decisivo 	decisive (decida)
declarar 	declararse en huelga 	strike (striki)
decorar 	adorn, decorate, ornament (ornami)
decrecer 	abate, decrease, diminish, drop, fall (malplii?i)
decudir 	abstract, deduce, gather (dedukti); abstract, induce, gather, infer (konkludi)
dedo 	finger (fingro)
dedo de pie 	toe (piedfingro)
deducir 	countdown (dekalkuli)
defecto 	damage (difekto)
defender 	protect (protekti)
defensa 	defence, defense (defendo); protection (protektado)
definir 	define, determine (difini)
dejar 	allow, leave, let, release (lasi); leave behind (postlasi)
dejar en pos 	leave behind (postlasi)
dejo 	accent (prononcmaniero)
delante 	ahead, formerly, previously (anta?e)
delante de 	before, in front of (anta?)
delatar 	accuse, denounce (denunci)
delegar 	delegate (delegi); depute (deputi)
deletrear 	spell (literumi)
demandar 	ask, ask for, beg, bid, request (peti)
demasiado 	too, too much (tro)
demoler 	breakdown, demolish, pull down, takedown (malkonstrui)
demontar 	take apart (malmunti)
demostrable 	apparent (montrebla)
dengoso 	prudish (pruda)
dentista 	dentist (dentisto)
dentro 	inside (interne)
dentro de 	a, in, inside, into, on, per, within (en); inside, within (internede)
denuncia 	accusation (denunco)
denunciar 	accuse (akuzi); accuse, denounce (denunci); accuse (plendikontra?)
departamento 	departamento de fumar 	smokers (fumkupeo)
dependencia 	dependence (dependeco)
depender 	depend (dependi)
depender de 	be dependent on, depend on l depend upon (dependide)
dependienta 	saleswoman (vendistino)
dependiente 	dependent (dependa); clerk (komizo)
deplorable 	regrettable (beda?rinda); dismal, miserable, pitiful, poor (kompatinda)
deplorar 	be sorry about, regret (beda?ri); begrudge, regret (doma?i); mourn (priplori)
deporte 	sport (sporto)
depositar 	deposit (deponi)
derecho 	claim, presumption, pretence (pretendo); right (rajto); direct, straight (rekta)
derechos de consumo 	excise, excise ? d u t y (akcizo)
derivar 	derive (derivi)
derivar del rumbo 	drift, be adrift (drivi)
derramar 	pour, scatter, shed (ver?i)
derretir 	melt (fandi)
derretirse 	melt (fandi?i)
derribar 	breakdown, demolish, pull down, takedown (malkonstrui)
derribos 	rubbish, old materials (ruboj)
derrota 	defeat (malvenko)
derruirse 	crumble, crumble away, crumble off (peceti?i)
desaconsejar 	advise against, dissuade from (malkonsili)
desacostumbrar 	break of a habit, teach (dekutimigi)
desanimado 	dejected, depressed (korpremita)
desaprender 	unlearn (mallerni)
desaprobar 	condemn, disapprove, disapprove of, rebuke (malaprobi); reproach, rebuke, reprove, scold (malla?di)
desarrollar 	account for, explain (ekspliki); account for, clarify, explain (klarigi)
desatinar 	drivel, twaddle (parolisensence)
desayuno 	breakfast (matenman?o)
descalzo 	barefoot (nudpieda)
descansar 	repose, rest (ripozi)
descanso 	break, intermission, pause, recess (pa?zo); repose, rest (ripozo)
descargar 	write off (deprezi); ab react (forreagi); unload (mal?ar?i)
descendencia 	lineage (deveno); origin (origino)
descender 	accrue, come, derive, originate, result (deveni); descend, get off, go down (malsupreniri)
descendiente 	offspring, successor (posteulo)
descolgar 	abstract, take away (forpreni)
desconcharse 	flake off, peel off, scale off (deskvami?i)
desconocido 	unknown (nekonata)
describir 	describe (priskribi)
descubrimiento 	discovery (malkovro)
descubrir 	discover, uncover (malkovri)
descuento 	abatement, discount, rebate (rabato)
descuidado 	careless, negligent (neatenta); careless, negligent (senatenta)
descuidar 	neglect (neglekti)
desde 	from, since (ekde)
desear 	ache (deziregi); desire, wish (deziri)
desechos 	clippings, cuttings, parings, refuse, rubbish, waste, windfall (defala?o); remainder, rest (resta?o); debris, rubbish, rubble (rubo)
desembarcadero 	landing ? s t a g e, pier (albordi?ejo); landing ? s t a g e, pier (navighaltejo); landing ? s t a g e, pier (varfo)
desembocadura 	mouth (enfluejo)
desenfrenado 	lawless, licentious, riotous (senbrida)
desentenderse de 	ignore, leave out of account (ignori)
deseo 	avidity, covetousness, eagerness, greediness (avido); desire, want, wish (deziro)
desertar 	a post at ize, desert, secede (malfideli?i)
desfiladero 	pass (montpasejo)
desgastarse 	wear away, wear off, wear out (eluzi?i)
desgracia 	accident (akcidento)
desgraciadamente 	unfortunately (malbon?ance); unfortunately (malfeli?e)
deshielo 	melting, thaw (degelo)
deshonesto 	nasty (malhonesta)
desierto 	desert (dezerto)
designar 	indicate, suggest (indiki); indicate, point out, show (montri)
desigual 	bumpy (malebena); different (malegala); coarse, rough (malglata)
desinteresado 	disinterested (neprofitema)
desistir de 	relinquish, renounce, waive (rezignipri)
deslumbar 	dazzle (lum?eni)
desmayado 	unconscious (senkonscia)
desmayarse 	faint, swoon (sveni)
desmayo 	faint, swoon (sveno)
desmejorarse 	decline, go back, falloff (malpliboni?i)
desmoronarse 	crumble, crumble away, crumble off (peceti?i)
desnatar 	cream, skim (senkremigi)
desnudo 	bare, naked, nude (nuda)
despachar 	dispatch, send off, ship (ekspedi); conclude, dispatch, expedite, finnish, settle (finaran?i); dismiss, turn away (forsendi); send, transmit (sendi)
despacho 	demand, sale (debito)
despedida 	farewell, goodbye, good ? b y e (adia?o)
despedir 	dismiss, turn away (forsendi); discharge, dismiss, fire, sack (maldungi); discard (uzofini)
despedirse 	say goodbye, say goodbye to, take leave, take leave from (adia?i)
despojar 	rob (prirabi)
despreciar 	despise (malestimi)
desprecio 	contempt (malestimo)
desprendimiento de tierras 	landslide (grundadisfalo); landslide (ter?ovi?o)
despuntar 	blunt (malakrigi)
destajar 	make a contract (kontrakti)
destajista 	builder, contractor, building contractor, master builder (konstruentreprenisto)
destajo 	contract (kontrakto); tender (prezkonkurado)
desterrado 	exile (ekzilito)
destierro 	exile (ekzilo)
destinatario 	consign ee, recipient (ricevanto)
destino 	destiny, fate (destino)
destituir 	depose (detronigi)
destornillador 	screwdriver (?ra?bturnilo)
destreza 	expertness, skilful ness, skill, skillful ness (lerteco)
destruir 	destroy, quash (detrui)
desviar 	divert (forkonduki)
desviarse 	deviate (deklini?i); turn (devii); deflect, diverge, wander (flankeni?i)
detalle 	detail (detalo)
detective 	detective (detektivo)
detener 	arrest (aresti)
detenido 	arrested person, prisoner (arestito)
deteriorar 	damage, injure, spoil (difekti)
deterioro 	damage (difekto)
determinar 	determine, fix (determini)
detestar 	abhor, abominate, loathe (abomeni)
detrimento 	harm (malutilo)
detrito 	clippings, cuttings, parings, refuse, rubbish, waste, windfall (defala?o); remainder, rest (resta?o); debris, rubbish, rubble (rubo)
deuda 	debt (?uldo)
deudo 	relative (parenco)
devanar 	unroll, unwind, wind off (malbobeni); unroll (malvolvi)
devolver 	give back, return (redoni)
de acuerdo 	agreed, okay (konsentite)
de aire acondicionado 	air conditioned (aerklimatizita)
de confianza 	reliable, trustworthy (fidinda)
de cuando en cuando 	now and then (detempoaltempo)
de dia 	by day, during the day (dumtage); by day, during the day, in the daytime (tage)
de espaldas 	backward, on one ' s b a c k (dorsen); backwards (posten)
de golpe 	all of a sudden, suddenly (subite)
de hierro 	iron (fera)
de madera 	wooden (ligna)
de mala fama 	of ill repute (fifama)
de memoria 	by heart (parkere)
de ninguna manera 	by no means, in noway, not at all, not on any account (neniel)
de nuevo 	afresh, again, all over again, a new (denove); afresh, again, once more (ree)
de otra manera 	differently, else (alie); differently (alimaniere)
de paso 	by the way (parenteze)
de poca profundidad 	shallow, superficial (malprofunda)
de prisa 	fast, quickly, swiftly (rapide)
de repente 	all of a sudden, suddenly (subite)
de segunda mano 	secondhand, secondhand (brokanta)
de veras 	absolutely, gen u in ly, indeed, really, truly (vere)
diabetes 	diabetes (diabeto)
diamante 	diamond (diamanto)
diariamente 	daily (?iutage)
diario 	daily (?iutaga)
diarrea 	diarrhoea (diareo)
dibujar 	design, draw (desegni)
diccionario 	dictionary, vocabulary (vortaro)
dicho 	concerned, in question (koncerna)
diciembre 	December (decembro)
dieciocho 	eighteen (dekok)
diestro 	adroit, clever, dexterous, skillful (lerta)
dieta 	diet (dieto)
dietario 	agenda, appointment book (agendo)
diez 	ten (dek)
diez y nueve 	nineteen (dekna?)
diez y ocho 	eighteen (dekok)
diez y seis 	sixteen (dekses)
diez y siete 	seventeen (deksep)
diferencia 	difference (diferenco)
diferente 	different (diferenca)
diferir 	differ, be different (diferenci)
dificil 	difficult, hard, inconvenient (malfacila)
dificultar 	hamper, hinder, thwart (malfaciligi)
difundir 	send, transmit (sendi)
digresar 	stray from one ' s s u b j e c t, wander from one ' s s u b j e c t (detemi?i)
dimitir 	resign (demisii); quit, resign (eksi?i)
dinero 	money (mono)
dinero del embase 	pledge, security (garantia?o)
diputado 	delegate (delegito); delegate, deputy, representative (deputito)
diputar 	delegate (delegi); depute (deputi)
directamente 	at once, instantly, immediately, without delay (senprokraste)
director 	director, manager (direktoro)
directorio 	address list (adresaro)
dirigir 	address (adresi); conduct, guide, lead (konduki)
dirigirse 	go (iri)
dirigirse a 	accost, address (alparoli)
dirigir la palabra a 	accost, address (alparoli)
disco 	grammophon e disc (gramofondisko)
discreto 	discrete (diskreta)
disculpa 	apology (ekskuzo)
disculparse 	apologize (senkulpigisin)
disferente 	different (diferenca)
disfrutar 	delight in, enjoy (?ui)
disminuir 	abate, decrease, diminish (malkreski); abate, decrease, diminish, drop, fall (malplii?i)
disponible 	available (disponebla)
disputar 	quarrel, wrangle (kvereli)
distancia 	distance, offset (distanco)
distinguir 	distinguish (distingi)
distinto 	different (diferenca); different (malsama)
distraer 	distract, divert, entertain (distri)
distribuir 	distribute (distribui)
distrito 	district (distrikto)
divergente 	different (diferenca)
divertido 	amusing, entertaining, funny (amuza)
divertimento 	amusement, fun (amuzo)
divertir 	amuse (amuzi)
divertirse 	enjoy oneself, have a goodtime (amuzi?i)
dividir 	divide, separate, share (dividi)
divorcio 	divorce (eksedzi?o)
divulgar 	publish, reveal (publikigi); acquaint, let know, in form (sciigi)
doblar 	fold (faldi); bend (fleksi); bend (kurbigi)
doble 	double, dual (duobla)
doce 	twelve (dekdu)
doctor 	doctor, physician (kuracisto)
documento 	document, paper (dokumento)
doler 	ache, be painful, hurt (dolori)
dolerse por 	have compassion on, pity (kompati)
dolor 	ache, pain (doloro)
dolor de muelas 	toothache (dentdoloro)
domesticado 	tame (malsova?a)
domicilio 	abode, dwelling ? p l a c e, residence (domicilo); abode, dwelling ? p l a c e ? r e s i d e n c e (lo?loko)
dominga de Ramos 	PalmSunday (Palmofesto)
domingo 	Sunday (diman?o)
donde 	dormir 	be asleep, sleep (dormi)
dos 	two (du)
dosis 	dose (dozo)
dos veces 	twice (dufoje)
dotado 	gifted, talented (naturdotita); accomplished, talented (talenta); gifted, talented (talentplena)
dotar 	endow (doti)
dromedario 	dromedary (dromedaro)
ducha 	shower (du?o)
ducharse 	take a shower (du?isin)
duda 	hesitation, wavering (hezitado); hesitation (hezito)
dudar 	doubt (dubi)
dulce 	gentle, soft, sweet, tender (dol?a); delicacy, tidbit, sweet (franda?o)
durar 	continue, endure, keep on, last (da?ri)
duro 	hard (dura); leather (leda); hard (malmola)
dyschatell 	couch, divan (divano)
ebrio 	drunk, intoxicated (ebria)
echar 	throw (?eti)
echar a perder 	spoil (malbonigi)
echar la siesta 	doze, nap, slumber (dormeti)
edad 	age (a?o)
edad media 	MiddleAges (Mezepoko)
edificar 	erect, establish (establi); erect, establish, found (fondi); build, construct (konstrui)
edificio 	building (konstrua?o)
edificio anexo 	annexation (anekso)
editor 	publisher (eldonisto)
eficaz 	effective, effectual, efficacious (efika)
efigie 	effigy, head (monerfiguro)
egipcio 	Egyptian (egipta); Egyptian (egipto)
eje 	axis, axle (akso)
ejemplo 	example (ekzemplo)
ejercicio 	exercise, practice (ekzerco)
el 	the (la)
electricidad 	electricity (elektro)
elefante 	elephant (elefanto)
elegante 	elegant (eleganta); chic (?ika)
elegir 	choose, elect, pick out (elekti)
ella 	her, she (?i)
embajada 	embassy (ambasadejo); embassy (ambasado)
embajador 	ambassador (ambasadoro); ambassador, emissary, envoy, messenger (sendito)
embalsamar 	embalm (balzami); embalm (enbalzamigi)
embarcarse 	embark (en?ipi?i)
embargar 	confiscate (konfiski)
embelesar 	charm (?armi)
embotado 	blunt (malakra); dull, obtuse (obtuza)
embragar 	couple (kupli)
embriaguez 	drunkenness, in e brie ty (ebrieco)
embudo 	funnel (funelo)
embuste 	swindle (trompo)
embustero 	cheat, deceiver, imposter (trompanto)
emigrar 	emigrate (elmigri)
emigrarse 	emigrate (elmigri)
empacar 	pack, package, wrap up (enpaki)
empalmar 	correspond (kunrespondi)
empalme 	connection (kunrespondo)
empezar 	begin, commence, start (komenci); begin, commence, start (komenci?i)
empleado 	employee (dungito); clerk (komizo); officer, official (oficisto)
emplear 	apply, practice (apliki)
empleo 	post (posteno)
emprender 	undertake (entrepreni)
empresa 	industry (industrio)
empujar 	push, thrust (pu?i)
en 	a, in, inside, into, on, per, within (en); on, upon (sur)
enamorarse de 	fallin love with (enami?ial)
encadenamiento 	order (sinsekvo)
encajar 	palm off on (persvadia?eti)
encaje 	lace (punto)
encamado 	bedridden, confined to one ' s b e d, laid up (litmalsana)
encantador 	charming, lovely (?arma)
encantar 	attract, draw (allogi); charm (?armi)
encanto 	charm (?armo)
encargarse de 	undertake (entrepreni)
encendedor 	lighter (fajrilo)
encender 	burn (bruligi); kindle, light (ekbruligi); light (eklumigi); illuminate, light (lumigi)
encentar 	cut into (ektran?i)
enciclopedia 	encyclopaedia (enciklopedio)
encima de 	above, over (super)
encogido 	afraid, timid (timema)
encontrar 	come across, encounter, meet, see (renkonti); find (trovi)
encontrarse 	be found, be located, find oneself (trovi?i); be found, be located, find oneself (trovisin)
encuentro 	encounter (renkonto)
encuesta 	inquiry, investigation (enketo)
endrino 	sledge, sleigh (glitveturilo); sledge, sleigh (sledo)
enemigo 	adversary, enemy (malamiko)
enero 	January (januaro)
enfermera 	nurse (flegistino)
enfrenar 	brake (bremsi)
enfrente de 	opposite (fronteal); opposite (kontra?ede)
enfriar 	cool, cool down (malplivarmigi); get cold (malplivarmi?i)
enjugar 	dry (sekigi); delete, wipe, wipe off (vi?i)
enlace 	starting point (komencloko); connection (kunrespondo)
enmohecerse 	get mouldy (?imi)
enorme 	enormous (enorma)
enrollar 	envelop (envolvi)
ensalada 	salad (salato)
ensangrentado 	blood ? s t a i n e d, covered with blood (sangokovrita); blood ? s t a i n e d, covered with blood (sangomakulita)
enteblar 	begin, commence, start (komenci)
entender 	understand, realize (kompreni)
enteramente 	at all, entirely, quite, wholly (tute)
entero 	entire, overall, whole (tuta)
enterramiento 	burial, funeral, interment (enterigo); burial, funeral, interment (entombigo)
enterrar 	bury (enterigi); bury, entomb, inter (entombigi); flood, overwhelm (super?uti)
entierro 	burial, funeral, interment (enterigo); burial, funeral, interment (entombigo)
entonar 	intone, raise (ekkanti)
entonces 	then (tiam); then (tiuokaze)
entrada 	entrance, portal (enirejo); access, admission, admittance (eniro)
entrante 	future (estonta); close, near, nearby, next (proksima); following, next (sekvonta); next (venonta)
entrar 	go in, enter, perform (eniri)
entrar en cuenta 	be considered, count (estikonsiderata)
entre 	among, between (inter)
entrecortado 	broken (rompita)
entrega 	delivery (livero); delivery (transdono)
entregar 	hand, handover (enmanigi); deliver, furnish, supply (liveri); pass, spend (pasigi); convey, hand, handover, pass (transdoni)
entretener 	amuse (amuzi)
entristecer 	afflict, grieve (aflikti); afflict, cause pain, cause pain to, distress, give pain to (mal?ojigi)
envejecer 	be on the decline, go downhill, go off (kaduki?i)
envenenar 	poison (veneni)
enviar 	dispatch, send off, ship (ekspedi); dismiss, turn away (forsendi); send, transmit (sendi)
envidia 	envy (envio)
envidiar 	envy (envii)
envidioso 	envious (envia)
envolver 	pack, package, wrap up (enpaki)
en alta voz 	loudly (la?te)
en casa 	at home (hejme)
en cuanto a 	about, concerning (koncerne); about, concerning, on, upon (pri); as to, as regards, concerning (rilate)
en efecto 	absolutely, actually, in fact (efektive); absolutely, gen u in ly, indeed, really, truly (vere)
en el acto 	at once, immediately, just, right away, right now (tuj)
en el extranjero 	abroad (alilande)
en el fondo 	below, downstairs, underneath (malsupre)
en ninguna parte 	nowhere (nenie)
en orden 	agreed, okay (konsentite)
en otra parte 	elsewhere (aliloke)
en parte 	partially, partly (parte)
en pos 	at the back, behind, in the rear (jelafino); behind (malanta?e)
en primer lugar 	first, firstly, first of all (unue)
en principio 	in principle (principe)
en realidad 	absolutely, gen u in ly, indeed, really, truly (vere)
en seguida 	at once, instantly, immediately, without delay (senprokraste); at once, immediately, just, right away, right now (tuj)
en su mayor parte 	for the greater part, for the most part (grandparte); for the greater part, for the most part (?efparte)
en todas partes 	all about, everywhere (?ie); everywhere (?iuloke)
en todos conceptos 	in every way (?iel); in all respects, in every respect, in every way (?iurilate)
en torno de 	about, round, around, towards (?irka?)
en un principio 	at first, at the outset, in the beginning (enlakomenco); at first, at the outset, in the beginning (komence)
en vano 	in vain (vane)
equipaje 	baggage, luggage (paka?o)
equipajes 	baggage, luggage (paka?o)
equis 	X (ikso)
equivocarse 	err, make a mistake (erari)
error 	aberration, error, mistake (eraro)
escala 	ladder (?tupetaro)
escalar 	ascend, climb, scale (surgrimpi)
escalera 	staircase, stairs (?tuparo)
escama 	scale (skvamo)
escandaloso 	aggravating (indigniga)
escaparate 	show window (montrofenestro)
escarola 	endive (endivio)
escarpado 	abrupt, steep (kruta)
esclusa 	lock, sluice (kluzo)
escoger 	choose, elect, pick out (elekti)
escombro 	mackerel (skombro)
escopeta 	gun, rifle (fusilo)
escribir 	write (skribi)
escrupuloso 	accurate, scrupulous (skrupula)
escuchar 	listen (a?skulti)
escuela 	school (lernejo)
escultor 	sculptor (skulptisto)
escupir 	spit (kra?i); spit (sputi)
esforzarse por 	aim, attempt, endeavour, take steps, undertake (klopodi)
eslavo 	Slavic (slava); Slav (slavo)
eso 	that, that over there, those (tio)
espacio 	room, space (spaco)
espalda 	back (dorso)
espantar 	deter, discourage, scare (fortimigi)
espanto 	fright (timego)
esparadrapo 	plaster (plastro)
especia 	spice (spico)
especial 	particular, special (speciala)
especie 	kind, sort (speco)
espejo 	looking ? g l a s s, mirror (spegulo)
esperanto 	Esperanto (esperanto)
esperanza 	hope (espero)
esperar 	foresee (anta?vidi); abide, expect, wait, await, wait for (atendi); hope (esperi); bide, abide, stay for, wait, await, wait for (?isatendi)
espiga 	ear (spiko)
espinaca 	spinach (spinaco)
espina dorsal 	spine (spino)
espolear 	encourage, impel, instigate, spur on, stimulate, urge (instigi); incite, rouse, spur, stimulate, stir up (sproni)
esponja 	sponge (spongo)
esposa 	wife (edzino)
esposo 	husband (edzo)
espuma 	foam, froth (?a?mo)
esputo 	mucus, phlegm (muko)
esqueleto 	skeleton (ostaro); skeleton (skeleto)
esquiar 	ski (skii)
esquimal 	Eskimo (eskimo)
esquina 	esta 	these, this, this here (tio?i); these, this, this here (?itio)
establo 	stable, stall, sty (stalo)
estado 	state (?tato)
estafar 	fleece (tropagigi)
estandarte 	flag, standard (standardo)
estanque 	pond (lageto)
estar 	estar ...ando 	busy oneself (esti...anta)
estar de acuerdo con 	agree to (konsentipri)
estar de pie 	stand (stari)
estar sentado 	s it (sidi)
estar tendido 	lie, recline (ku?i)
estatua 	statue (statuo)
esta tarde 	this evening (hodia?vespere)
este 	east, East (oriento)
estima 	esteem, regard (estimo); esteem, regard, respect (?atateco)
estimar 	esteem, think well of (estimi); appraise, estimate, rate (taksi)
estimular 	rouse, stimulate, stir up (stimuli)
estipular 	set conditions, stipulate (kondi?i)
estorbar 	bar, inhibit, prevent (malebligi); bar, hinder, inhibit, prevent (malhelpi)
estornudar 	sneeze (terni)
estrecho 	narrow (mallar?a); close, cramped (malvasta); strait (markolo)
estrella 	star (stelo)
estrofa 	verse (strofo)
estropeado 	broken, damaged (difektita)
estuche 	jug, box, container, vessel (ujo)
estudiante 	academic, student (studento)
estudiar 	learn (lerni); study (studi)
estudio 	study (studo)
estufa 	furnace, kiln, oven, stove (forno)
es decir 	that is (tioestas)
europeo 	European (e?ropa); European (e?ropano)
evidente 	clear, distinct, plain (klara)
evidentemente 	apparently, obviously (evidente)
evitar 	avoid, evade (eviti)
exacto 	exact (ekzakta)
exagerar 	exaggerate (troigi)
examen 	investigation, examination, test (ekzameno)
examinar 	examine (ekzameni)
excelente 	fine, great (bonega)
excepto 	apart from, but, except, other than (escepte)
excluir 	exclude (ekskludi)
excusado 	toilet (necesejo)
exhortar 	admonish, scold (admoni)
exigir 	demand, postulate, require (postuli)
existencia 	existence (ekzisto)
existir 	exist (ekzisti)
expedir 	dispatch, send off, ship (ekspedi); dismiss, turn away (forsendi)
experiencia 	experience (sperto)
experto 	experienced, expert, skilful, skilled, skillful, practised (ekzercita); adroit, clever, dexterous, skillful (lerta)
expirar 	end, come to an end, end up, expire (fini?i)
explicar 	account for, explain (ekspliki); account for, clarify, explain (klarigi)
explotar 	exploit, utilize (ekspluati)
exterior 	external, outer, outside (ekstera)
externo 	external, outer, outside (ekstera)
extra 	additional, extra (ekstra)
extracto 	extract, infusion (infuza?o)
extranjero 	alien, foreigner (alilandano); alien, foreign (eksterlanda); foreigner (eksterlandano)
extraviarse 	go astray, stray off (devoji?i)
extremamente 	extremely (ekstreme); most (plej)
fabricar 	fabricate, manufacture (fabriki); achieve, act, do, make, perform (fari)
falaz 	deceptive, delusive, fallacious (erariga); deceitful (trompa)
falda 	skirt (jupo)
falta 	absence, lack, shortage, shortcoming (manko)
faltar 	be lacking, be missing (manki)
familia 	family (familio)
familiar 	relative (parenco)
famoso 	famous (fama); famous (famkonata); famous, glorious (glora); famous (renoma)
fardo 	bale (pakego)
farmacia 	chemist ' s s h o p, drugstore (apoteko)
faro 	headlight (reflektoro)
farol 	lantern (lanterno)
farsante 	attitudinize r, poseur (afektulo)
fatal 	fateful, ill ? f a t e d (fatala)
fatigar 	fag out, jade, overdrive, override (lacegigi)
favor 	favor, favour (favoro)
favorable 	advantageous, favourable (favora)
favorecer 	favor, favour (favori)
faz 	face (viza?o)
febrero 	February (februaro)
fecha 	date (dato)
federal 	federal (federala)
felicitar 	congratulate (gratuli)
feminino 	female, feminine (ina)
fender 	split (fendi)
fenomenal 	phenomenal (fenomena)
feo 	nasty, ugly (malbela)
fidedigno 	plausible (kredebla); plausible (kredinda)
fiebre 	ague, fever (febro)
fiel 	faithful (fidela)
fiero 	savage, wild (sova?a)
fiesta 	celebration, festival, party (festo)
figurado 	figurative (figura)
figurarse 	fancy, imagine (imagi)
fijar 	attach, determine, fasten, fix, affix, make fast, secure (fiksi)
fijo 	fixed (fiksa); fast, firm, stable (firma)
fila 	grade, rank, rate (rango)
filete 	slice (tran?a?o)
filtro 	filter (filtrilo)
fin 	aim, goal, purpose, target (celo); end, ending (fino)
final 	end, ending (fino)
finalmente 	at last, finally, ultimately (fine)
finca 	estate, farm, property, ranch (bieno)
finesa 	Finnish, Finnishwoman (finnino)
fingir 	give as an excuse, pretend (preteksti); feign, pretend (?ajnigi)
finlandesa 	Finnish, Finnishwoman (finnino)
fino 	dainty, delicate, fine, refined (delikata); gaunt, lean, slender, thin (maldika)
firma 	company, firm (firmao); signature (subskribo)
firmar 	sign (subskribi)
flamenco 	Flemmish (flandra); Flemming (flandro)
flan 	cream (krema?o)
flauta 	flute (fluto)
flecha 	arrow (sago)
flema 	mucus, phlegm (muko)
flor 	bloom, flower (floro)
florin 	guilder, gulden (guldeno)
foca 	seal, sea ? d o g (foko)
folleto 	leaflet, pamphlet, paperback (bro?uro)
fondear 	anchor (ankrumi)
fondo 	background (fono); background (malanta?plano)
formulario 	blank, form (formularo)
forrar 	cover, overlay (tegi)
forro 	lining (sub?tofo)
forta leza 	fortress (fortreso)
forzar 	compel, force (devigi)
foto 	photograph (foto); photograph (fotografa?o)
frambuesa 	raspberry (frambo)
francesa 	Frenchwoman (francino)
franela 	flannel (flanelo)
franqueo 	postage (afranko)
frase 	sentence (frazo)
fregadero 	dresser (kuirejstablo)
fregar 	wash up (lavpurigilaman?ilaron)
freir 	fry (friti)
freno 	brake (bremso)
freno de emergencia 	communication ? c o r d (alarmbremso)
frente 	forehead (frunto)
fresa 	strawberry (frago)
fresco 	fresh, recent (fre?a); cool (malvarmeta)
fresno 	ash (frakseno)
friolera 	trifle (bagatelo)
frisio 	Frisian (frisa); Frisian (frizona); Frisian (frizono)
frisona 	Frisian, Frisianwoman (frizonino)
frontera 	boundary, frontier, limit (limo)
frotar 	rub (froti)
fruta 	fruit (frukto)
frutal 	fruit ? t r e e (fruktarbo)
fuego 	fire (fajro)
fuente 	fountain (fontano); fountain, source, spring (fonto); basin, bowl, pelvis (pelvo)
fuera 	abroad, out, outside (ekstere)
fuera de 	outside, outside of (ekster)
fuerte 	strong (forta); firm, robust, sturdy (fortika); firm, solid (solida)
fuerza 	force, strength, vigour (forto)
fuerza de caballos 	horsepower (?evalforto); horsepower (?evalpovo)
fulminante 	acute (akuta)
fumar 	smoke (fumi)
funcionar 	function, operate, run, work (funkcii)
funcionario 	officer, official (oficisto)
fundar 	base (bazi); erect, establish, found (fondi)
fusilar 	shoot dead (mortpafi)
gafas 	glasses, spectacles (okulvitroj)
gafas oscuras 	sun ? g l a s s e s (sunvitroj)
gallego 	Galician (galica)
galleta 	biscuit, cookie (biskvito)
gallina 	chicken, fowl (kokino)
gallo 	cock, rooster (virkoko)
ganado 	livestock (brutaro)
ganancia 	accession, acquisition, gain (akira?o); accession, acquisition, asset (akiro)
ganar 	earn, gain, win (gajni)
gancho 	hook (hoko)
ganso 	goose (ansero)
garaje 	garage (gara?o)
garganta 	throat (gor?o)
garra 	claw (ungego)
garrafa 	carafe, decanter (karafo)
gas 	gas (gaso)
gasolina 	gasolene, gasoline, petrol (benzino)
gastado 	worn (eluzita)
gastar 	pay out, spend (elspezi)
gastos 	charge, cost, expense (kostoj)
gas natural 	natural gas (tergaso)
gata 	female cat (katino)
gato 	cat (kato); jack (kriko)
gaviota 	seagull (mevo)
gemelos 	twins (dunaskitoj); twin (?emelo)
gemir 	groan, moan (?emi)
general 	general, usual (?enerala)
generalmente 	generally (?enerale)
gente 	people (homoj)
gerente 	manager (administranto); administrator (administristo); manager (direktanto)
ginebra 	g in (?ino)
girar 	turn (turni?i); endorse (?iri)
giro postal 	money order (po?tmandato)
gobernar 	control, govern, restrain, rule (regi)
gobierno 	administration, government (registaro)
godo 	Goth (goto)
golondrina 	swallow (hirundo)
golpe 	blow (bato)
golpear 	beat, hit, strike (bati)
goma 	rubber (ka??uko); rubber (skrapgumo)
gordo 	fat, fatty, greasy (grasa)
gorro 	cap (kaskedo); cap (?apo)
gota 	arthritis (artrito); drip, drop (guto); gout (podagro)
grabado 	image, picture (bildo)
gracia 	charm (?armo)
gracias 	gratitude, thanks (danko); thankyou, thanks (dankon)
gracioso 	affable, friendly, good ? n a t u r e d, kind (afabla)
grado 	degree, grade (grado)
gram 	gram, gram me (gramo)
grande 	big, great, large (granda)
granero 	barn, shed, stand (budo)
granito 	granite (granito)
granizo 	hail (hajlo)
granja 	estate, farm, property, ranch (bieno)
grasa 	fat, grease (graso)
gratitud 	gratitude (dankemo)
gratuito 	free (senpaga)
grave 	important, serious (grava); court, yard, courtyard (korto); alarming, grave, serious (maltrankviliga)
greda 	chalk (kreto)
grieco 	Greek (greko)
griega 	Greekwoman (grekino)
griego 	Greek (greka); Greek (heleno)
grieta 	crack, crevice (fendo); burst, crack, flaw (kreva?o)
grifo 	faucet, tap (krano)
gripe 	flu, grip, influenza (gripo)
gris 	grey (griza)
gritar 	cry out, scream, shout (krii)
grito 	cry, shout (krio)
grosella 	gooseberry (groso); currant (ribo); currant, redcurrant (ru?aribo)
grosero 	rude (mal?entila)
grueso 	bold, corpulent, fat, thick (dika); fat, fatty, greasy (grasa)
grupo 	guante 	glove, mitten (ganto)
guardabarros 	mudguard (kot?irmilo)
guardar 	guard, preserve, protect, save (anta?gardi); conserve, keep, maintain, preserve (konservi); protect (protekti); shelter, protect (?irmi)
guardarropa 	cloakroom (vestejo)
guardia 	guard (gardo); policeman (policano); policeman (policisto)
guardiamarina 	middy, mid ships man, naval cadet (mid?ipmano)
guerra 	war (milito)
guiar 	conduct, direct, guide, head, lead (gvidi)
guisante 	pea (pizo)
gusano 	worm (vermo)
gustar 	please (pla?i); appreciate, like (?ati)
gusto 	taste (gusto)
haba 	bean (fabo)
haber 	credit (kredito)
habilidad 	ability (kapableco)
habitante 	inhabitant (enlo?anto); inhabitant (lo?anto)
habitar 	dwell, live (lo?i)
habituarse 	accustom oneself, get used (kutimi?i)
hablar 	speak, talk (paroli)
hacer 	achieve, act, do, make, perform (fari); accomplish, achieve, keep, observe, perform (plenumi)
hacerse 	become, come about, grow, happen (fari?i); become, get, grow (i?i)
hacer incribir 	register (enskribigi)
hacer las compras 	shop (butikumi)
hacer la manicura 	manicure (manikuri)
hacer uso de 	employ, use, make use of (uzi)
hace ... 	...ago (anta?...)
hace poco 	just, just now (?us)
hacha 	axe (hakilo)
hallar 	come across, encounter, meet, see (renkonti); find (trovi)
hallarse 	be found, be located, find oneself (trovi?i); be found, be located, find oneself (trovisin)
hambre 	fame, hearsay, renown, repute, rumor, rumour (famo); hunger (malsato)
harina 	flour (bakfaruno); flour, meal (faruno)
hasta la vista 	bye, goodbye, so long (?isrevido)
hasta luego 	bye, goodbye, so long (?isrevido)
hasta que 	until, till (?is)
hay 	there is, there are (estas)
haya 	beech (fago)
haz el favor 	please (bonvolu)
haz favor 	please (bonvolu)
hebilla 	buckle (buko)
hebraico 	Hebrew, Jewish (hebrea); Hebrew, Jew (hebreo)
hebreo 	Hebrew, Jewish (hebrea); Hebrew, Jew (hebreo); Israelite (israelido)
hecho 	fact (fakto)
hectolitro 	he c to litre (hektolitro)
helada 	freezing cold, frost (frosto); frost (gelo)
hemorroides 	hae mor hoi ds (hemoroidoj)
hendedura 	crack, crevice (fendo); burst, crack, flaw (kreva?o)
henderse 	burst, split (fendi?i); burst (krevi)
hendidura 	ravine (ravino)
heno 	hay (fojno)
heredar 	inherit (heredi)
herida 	injury, wound (vundo)
herido 	injured, wounded (vundita)
herir 	hurt, wound (vundi)
hermana 	sister (fratino)
hermano 	brother (frato)
hermanos 	brothers and sisters, siblings (gefratoj)
hermoso 	lovely (belega)
herramienta 	agent, means, tool (ilo)
hervir 	boil (boli)
hiedra 	ivy (hedero)
hielo 	ice (glacio)
hiena 	hyaena (hieno)
hierba 	hierro 	iron (fero)
higo 	fig (figo)
higuera 	fig ? t r e e (figarbo); fig ? t r e e (figujo)
hija 	daughter (filino)
hijo 	son (filo)
hilo 	thread (fadeno)
hinchable 	air bed, air mattress (pne?matikamatraco)
historia 	story, history (historio)
hoja 	leaf, sheet (folio); blank, form (formularo)
hojalata 	sheet metal, tin, tin plate (lado)
hoja de afeitar 	razor ? b l a d e (razklingo)
hombre 	man, human being (homo); fellow, man (viro)
hombre de ciencia 	scientist (sciencisto)
hombro 	shoulder (?ultro)
homenaje 	honor, honour (honoro)
hongo 	mushroom (?ampinjono)
honor 	honor, honour (honoro)
honorable 	respectable (estiminda)
honrado 	above ? b o a r d, honest (honesta)
hora 	hour, o'clock, time (horo)
horario 	schedule, time ? t a b l e (horaro)
horizonte 	horizon (horizonto)
hormiga 	ant, emmet (formiko)
hornada 	baked goods (baka?o)
horrible 	abhorrent, abominable, alien, awful, hideous, horrible, gruesome (abomeninda); bleak, dismal, dreary, horrible, ghastly, grisly, nasty (malagrabla); dismal, dreary, horrible, nasty (malbelega); agonizing, hideous, horrible, ghastly (terurega)
horror 	abhorrence, abomination, horror (abomeno); abhorrence, horror (terurego)
horroroso 	abhorrent, abominable, alien, awful, hideous, horrible, gruesome (abomeninda); dismal, dreary, horrible, nasty (malbelega); agonizing, hideous, horrible, ghastly (terurega)
hospital 	hospital (malsanulejo)
hospitalidad 	hospitality (gastamo)
hotel 	hotel (hotelo)
hoy 	today (hodia?)
hueco 	fantastic, of fantasy (fantazia); frivolous (frivola); concave, hollow (kava); cavity (kava?o); hollow (kaverna); cave, cavity (kavo); airy ? f a i r y (malserioza); conceited, frivolous, vain (vanta); chimerical (?imera)
huelga 	strike (striko)
hueso 	bone (osto)
huevas 	spawn (frajo)
huevo 	egg (ovo)
huevo frito 	boiled egg (frititaovo)
huir 	flee, runaway (fu?i)
humear 	smoke (fumi)
humedo 	damp, humid, moist (humida); moist (malseketa)
humillante 	humiliating (humiliga)
hurtar 	rob (pri?teli)
idea 	idea (ideo); concept, idea (koncepto)
ideal 	ideal (ideala)
idem 	equally, likewise (same)
identificar 	identify (identigi)
iglesia 	church, church ? b u i l d i n g, house of worship, place of worship (pre?ejo)
igual 	equal, even, level (egala)
igualdad 	draw, equality (egaleco)
iguana 	iguana (igvano)
imagen 	image, picture (bildo)
imitar 	imitate (imiti)
impedimento 	handicap, impediment, obstacle (malhelpa?o)
impedir 	bar, inhibit, prevent (malebligi); bar, hinder, inhibit, prevent (malhelpi)
imperdible 	safety ? p i n, safety pin (fibolo)
imperio 	empire (imperio)
implorar 	implore, invoke (elpetigi)
imponer 	tax (imposti)
importancia 	concern (graveco)
importante 	important, serious (grava)
importar 	amount to (sumi?ije)
importe 	amount, sum (sumo)
imposible 	impossible (neebla)
imprimir 	print (presi)
impuesto 	tax (imposto)
incendio 	conflagration, fire (incendio)
incitar 	encourage, impel, instigate, spur on, stimulate, urge (instigi); cheer, fire, inspire, stimulate (plifervorigi); fan, fire, inspire, stimulate, stir up, urge on (plivigligi); rouse, stimulate, stir up (stimuli)
inclemente 	severe, strict (severa)
inclinado 	oblique, slanting (oblikva)
incomodar 	bother, disturb, hinder, trouble (?eni)
inconveniente 	difficulty, trouble (malfacila?o)
incremento 	accretion, growth (kresko)
indeciso 	indecisive (?anceli?ema)
indemnizar 	compensate (kompensi)
indicar 	indicate, suggest (indiki); indicate, point out, show (montri)
indicio 	index (indico); indication (indiko)
indico 	Indian (hinda)
indigencia 	misery (mizero); destitution, distress, indigence, need, penury (senhaveco)
indigente 	miserable, poor (malri?a); miserable, needy (senhava)
indio 	Indian (hinda); Indian (hindo); Indian, RedIndian (indiana)
indio americano 	Indian, AmericanIndian (indiano)
indispuesta 	not well, upset (malsaneta)
individuo 	individual (individuo)
indole 	character, nature, personality (karaktero)
indonesio 	Indonesian (indonezia)
indulgencia 	indulgence (indulgenco)
infamar 	slander (kalumnii)
infectar 	infect (infekti)
infeliz 	unhappy (malfeli?a)
inferior 	inferior (malsupera)
inficionar 	infect (infekti); communicate (konta?i)
inflar 	inflate (?veligi)
influir en 	act, affect, influence (influi)
informar 	acquaint, in form, report (informi); communicate, report (komuniki); acquaint, let know, in form (sciigi)
ingeniero 	engineer (in?eniero)
ingenuo 	guileless, inoffensive (senmalica)
inglesa 	English, Englishwoman (anglino)
ingrediente 	component, element, ingredient, part (ingredienco)
iniciador 	pioneer (pioniro)
inicial 	initial (komenca)
injuria 	abuse, insult (insulto); abuse (ofendo)
injuriar 	abuse, insult, offend (insulti); jeer, jeer at, taunt (mokinsulti)
inmediatamente 	at once, immediately, just, right away, right now (tuj)
innato 	congenital, in born, inbred, innate, native (denaska); con gent it al, in born, inbred, innate, native (kunnaskita)
innovador 	pioneer (pionira)
inocente 	guiltless, innocent (senkulpa)
inpulsar 	encourage, impel, instigate, spur on, stimulate, urge (instigi)
inquieto 	agitated, anxious (maltrankvila)
inscribir 	enter (enskribi); record, register (registri)
insecto 	bug, insect (insekto)
insistencia 	insistence, pressure, urgency (insistado); insistence, pressure, urgency (insisto)
insistir 	insist (insisti)
insolente 	rude (mal?entila)
inspector 	checker, controller (kontrolisto)
instancia 	insistence, pressure, urgency (insistado); insistence, pressure, urgency (insisto)
instar 	insist (insisti)
instigador 	firebrand, instigator (incitanto)
instigar 	abet, excite, incite, provoke, rouse, stimulate, stir up (inciti); initiate, start (iniciati); activate, cause, give rise to (ka?zi)
instinto 	access, impetus, impulse (impulso); instinct (instinkto)
instruir 	teach (instrui)
instrumento 	agent, means, tool (ilo)
insultar 	jeer, jeer at, taunt (mokinsulti); abuse, insult, offend (ofendi)
insulto 	abuse, insult (insulto)
inteligencia 	notion, sense, realization (kompreno); understanding (komprenpovo)
inteligible 	understandable (komprenebla)
intentar 	attempt, test, try (provi)
interesante 	interesting (interesa)
interesar 	interest (interesi)
interior 	inner, inside, internal (interna)
interna 	inner, inside, internal (interna)
interprete 	interpreter (interpretisto)
interrumpir 	interrupt (interrompi)
interruptor 	switch (?altilo)
intestinos 	intestines (intestaro)
inventar 	invent (elpensi); invent (inventi)
invierno 	winter (vintro)
invitar 	invite (inviti)
invocar 	invoke (alpre?i); invoke (alvokipre?e)
ir 	go (iri)
irregular 	abnormal (abnorma); abnormal (anormala); abnormal (nenorma); abnormal (nenormala)
irse 	go (iri)
ir a buscar a 	take along (kunvenigi); meet, pickup (veniporakompani)
ir por 	fetch, get, pickup (irpreni)
isla 	island (insulo)
islas Filipinas 	PhilippineIslands, Philippines (Filipinoj)
israelita 	Israelite (israelido)
italiana 	Italianwoman (italino)
italiano 	Italian (itala); Italian, Italianlanguage (italalingvo); Italian (italo)
jadeante 	breathless (senspira)
japonesa 	Japanesewoman (japanino)
jardinero 	gardener (?ardenisto)
jarra 	jug, pitcher (kru?o)
jarro 	jug, pot (poto); jug, box, container, vessel (ujo)
javanesa 	Javanesewoman (javanino)
jefe 	boss, chief, leader (estro); chief, superior (superulo); chef (?efkuiristo); chief, boss (?efo)
jengibre 	ginger (zingibro)
jerez 	sherry (?ereo)
jirafa 	giraffe (?irafo)
joven 	young (juna); youngster, youth (junulo)
joya 	gem, jewel (gemo); jewel (juvelo)
joyero 	jeweller (gemisto); jeweller (juvelisto)
juego 	game (ludo)
juego de damas 	checkers (damludo)
jueves 	Thursday (?a?do)
juez 	judge (ju?isto)
jugar 	jugo 	juice, sap (suko)
jugo de grosellas 	currant juice (ribsuko)
jugo de manzana 	apple juice (pomsuko)
juguete 	toy (ludilo)
juicio 	judgment (ju?o)
julio 	July (julio)
junco 	cane, reed (kano)
junio 	June (junio)
juntamente 	together (kune); at the sametime (samtempe)
juntar 	join, unite (kunigi)
juntarse 	associate, come together, join, pool (kuni?i); associate, join, pool (unui?i)
jurar 	blaspheme, cuss, curse, swear (blasfemi); swear (?uri)
justamente 	exactly (ekzakte); exactly, sharp (precize)
juventud 	youth (juneco)
juzgado 	tribunal (tribunalo)
juzgar 	judge (ju?i); judge (priju?i)
kilo 	kilo (kilogramo)
la 	the (la)
labio 	lip (lipo)
laborioso 	active, hardworking (laborema)
labrador 	builder (konstruisto)
lado 	side (flanko)
lado inferior 	bottom (malsupraflanko)
ladrar 	give tongue, bark (ekboji)
ladrillo 	brick (briko)
lago 	lake, loch (lago)
lamer 	lick (leki)
lanchamotora 	motor ? b o a t, motor ? l a u n c h (motorboato)
langosta 	lobster (omaro)
lanzar 	throw (?eti)
largo 	long (longa)
largura 	length (longeco); length (longo)
las 	the (la)
lastre 	ballast (balasto)
lata 	can, tin, tin can (ladskatolo)
latino 	Latin (latina)
laurel 	laurel (la?ro)
lava 	lava (lafo)
lavadero 	laundry (lesivejo)
lavaplatos 	dishwasher (porman?ilaralavma?ino)
lavar 	wash (lavi); wash up (lavpurigilaman?ilaron); wash (lesivi)
lazo 	bond, tie (ligilo); connection, league (ligo)
leche 	milk (lakto)
lecho 	bed (lito)
lechuga 	lettuce (laktuko)
leer 	read (legi)
lejano 	distant, far, remote (malproksima)
lejos 	away (for); a far, far, faraway, remotely (malproksime)
lengua 	tongue (lango); language, tongue (lingvo)
lenguado 	sole (soleo)
lenguaje figurado 	metaphor (metaforo)
lente 	lens (lenso)
lenteja 	lentil (lento)
lento 	slow (malrapida)
levantar 	lever, lift, raise (levi)
levantarse 	getup, rise, stand, stand up (ekstari); getup, rise, stand, stand up (stari?i)
ley 	law (le?o)
liar 	bind, connect, join, tie, tie up (ligi)
libertino 	lawless, licentious, riotous (senbrida)
libra 	pound (funto); plate, sheet, slab (plato)
librero 	bookseller (librovendisto)
libritode memoria 	notebook (notlibro)
libro 	book (libro)
licor 	liqueur (likvoro)
liebre 	hare (leporo)
liebre macho 	buck, buck ? h a r e (virleporo)
ligar 	bind, connect, join, tie, tie up (ligi)
ligero 	light (malpeza)
lila 	lilac (siringo)
lima 	file (fajlilo)
limitado 	confined, limited, restricted (limigita)
limitar 	a bridge, confine, limit, restrict (limigi)
limosna 	alms, charity (almozo)
limpiar 	polish (poluri); clean, cleanse, make clean, purge (purigi); delete, wipe, wipe off (vi?i)
limpieza 	cleanliness, purity (pureco)
limpio 	lince 	lynx (linko)
lindo 	delightful, lovely (rava); charming, lovely (?arma)
lisera 	shoulder, verge, verge of a road (vojbordero)
liso 	even, flat, level, smooth (ebena); smooth (glata)
lista 	list (listo); menu (man?okarto); menu (menuo)
lista de precios 	price ? l i s t (prezlisto)
listo 	finished, ready, through (preta)
litro 	liter, litre (litro)
llama 	flame (flamo)
llamada 	appeal (apelo); parade, roll ? c a l l (kolekti?o); parade, roll ? c a l l (kunvoko)
llamar 	appeal to, invoke (alvoki); hit, knock, strike (frapi); call (nomi); call, summon (voki)
llamarse 	be called (nomi?i)
llamar a la puerta 	knock at the door, rap at the door (frapisurlapordon)
llano 	plain (ebena?o); flat (plata)
llanta 	fell y, fell oe, rim (radrondo)
llanura 	plain (ebena?o)
llave 	key, wrench (?losilo); adjustable wrench, spanner (?ra?b?losilo)
llave inglesa 	monkey ? w r e n c h, shifting spanner (universala?ra?bilo)
llegada 	arrival (alveno)
llegar 	pass, spend (pasigi)
llenar 	complete (kompletigi); fill, fill in, fill up (plenigi)
lleno 	complete, full (plena)
llevar 	bring, fetch (alporti); bring along, take along (kunporti); carry, wear (porti); wear (surhavi)
llorar 	cry, weep (plori)
llover 	rain (pluvi)
lluvia 	rain (pluvo)
lo 	the (la)
lobo 	wolf (lupo)
loma 	hill (monteto)
londinense 	Londoner (londonano)
loro 	parrot (papago)
los 	the (la)
los dos 	both (amba?)
loza 	crockery, earthenware, pottery (fajenco); pottery (pota?o)
lucio 	pike (ezoko)
lucir 	shine (brili)
luego 	soon (balda?); afterwards, next, subsequently (poste); beyond, next, then, thereafter (posttio)
lugar 	inducement, occasion, motive (instigaka?zo); inducement, motive, occasion (instigaokaza?o); account, motive, reason (motivo)
lujo 	luxury (lukso)
lumbar 	loin (lumbo)
luna 	moon (luno)
lunes 	Monday (lundo)
luz 	light (lumo)
luz de Bengala 	bengal ? l i g h t, bengal ? l i g h t s (bengalafajro)
luz posterior 	rear ? l a m p, rear ? l i g h t, tail ? l i g h t (malanta?alampo)
luz trasera 	rear ? l a m p, rear ? l i g h t, tail ? l i g h t (malanta?alampo)
macarrones 	macaroni (makaronio)
maciso 	massive (masiva)
madera 	timber, wood (ligno)
madre 	bed, watercourse (fluejo); mother (patrino)
maduro 	mature, ripe (matura)
maestra 	teacher, female teacher (instruistino)
maestro 	instructor, teacher (instruisto)
majo 	pretty (beleta)
malayo 	Malay (malaja); Malay (malajo)
mala costumbre 	habit, trick (alkutima?o)
mala suerte 	bad luck (malbon?anco)
malentendido 	misunderstanding (miskompreno)
maleta 	trunk (kofro); suitcase, valise (valizo)
maleta de mano 	suitcase, valise (valizo)
malo 	erroneous, mistaken, wrong (erara); bad, miserable, nasty, poor (malbona)
mal olor 	stench (fetoro)
mal reputado 	of ill repute (fifama)
mancha 	blot, spot (makulo)
mandar 	direct, guide, manage, steer (direkti); steer (stiri)
mandarina 	tangerine (mandarino)
mandato 	command (komando)
mando 	command (komando)
manga 	sleeve (maniko)
manido 	stale (malfre?a)
mano 	hand (mano)
manso 	tame (malsova?a)
manta 	blanket (litkovrilo)
mantel 	table ? c l o t h (tablotuko)
mantequilla 	butter (butero); blueberry (mirtelo)
manzana 	apple (pomo)
manzano 	apple ? t r e e (pomujo)
mapa 	map (geografiakarto); map (mapo)
maquinar 	initiate, start (iniciati); activate, cause, give rise to (ka?zi)
mar 	sea (maro)
marcar 	dial (diski)
marea 	tide (tajdo)
mareado 	dizzy (kapturna)
marfil 	ivory (eburo)
margarina 	margarine (margarino)
marido 	husband (edzo)
marina 	navy (mararmeo)
marinero 	sailor (maristo)
mariposa 	butterfly (papilio)
martes 	Tuesday (mardo)
martes de carnestolendas 	Shrove?Tuesday (Anta?fastaMardo)
martillo 	hammer (martelo)
marzo 	March (marto)
mar Rojo 	RedSea (Ru?aMaro)
mar del Norte 	NorthSea (NordaMaro)
mas 	but (sed)
masa 	lump, mass (maso); dough, paste (pasto)
masaje 	massage (masa?o)
masajear 	massage (masa?i)
masculino 	male (maskla); male (virseksa)
masticar 	chew (ma?i)
matar 	butcher, slaughter (bu?i); kill, liquidate, slay (mortigi)
materia 	matter (materio)
material 	data, material (materialo)
matrimonio 	marriage, matrimony (edzeco); marriage (edzineco); marriage (geedzeco)
mayo 	May (majo)
mear 	urinate (pisi); urinate (urini)
mechero 	lighter (fajrilo)
media 	stocking (?trumpo)
media noche 	midnight (noktmezo)
medicamento 	drug, medicine, pharmaceutical (kuracilo)
medicina 	drug, medicine, pharmaceutical (kuracilo)
medida 	measure, measurement (mezuro)
medio 	half (duona); half (duono); agent, means, tool (ilo); average, mean, middle (mezo); means, remedy, resources (rimedo)
medir 	measure (mezuri)
medroso 	afraid (malkura?a); afraid (tima); afraid, fearful (timigita)
medusa 	jelly ? f i s h (meduzo)
mejicana 	Mexicanwoman (meksikianino)
mejicano 	Mexican (meksikiano)
mejikano 	Mexican (meksikia)
mejilla 	cheek (vango)
mejor 	better (plibona)
melindroso 	prudish (pruda)
mencionar 	cite, quote (citi); mention (mencii)
mendicidad 	begging (almozpetado)
mendigar 	beg (almozpeti)
mendigo 	beggar (almozulo)
menesteroso 	abject, dismal, meager, miserable, wretched (mizera); miserable, needy (senhava)
menguar 	abate, decrease, diminish, drop, fall (malplii?i)
menos 	apart from, but, except, other than (escepte); fewer, less (malpli)
menos y menos 	less and less (malplikajmalpli)
mensaje 	errand, message (mesa?o)
mensualmente 	monthly (?iumonate)
menta 	mint (mento)
mentir 	lie, tell a lie (mensogi)
mentira 	lie (mensogo)
mercado 	fair, market (foiro); market, sales activity (merkato); market, marketplace (vendoplaco)
mercado de consumo 	market, sales activity (merkato)
merecer 	be worthy of, deserve, merit (meriti)
merluza 	haddock (eglefino)
mermelada 	jam, m armel a de (marmelado)
mermelada de manzanas 	apple ? s a u c e (pomka?o); apple ? s a u c e (pomkompoto)
mes 	month (monato)
mesa 	table (tablo)
metal 	metal (metalo)
meter 	lay down, place, put, put down (meti)
meticuloso 	accurate, scrupulous (skrupula)
metro 	metre (metro); subway, underground (metroo)
mezcla 	admixture, mixture (miksa?o)
mezquino 	petty, small ? m i n d e d (etspirita)
mezquita 	mosque (moskeo)
mi 	my (mia)
miedo 	agony, anguish, fear (angoro); afraid (malkura?a); afraid (tima); fright (timego); afraid, timid (timema)
miedoso 	afraid (malkura?a); afraid (tima)
miel 	honey (mielo)
miembro 	limb, member (membro)
mil 	thousand, one thousand (mil)
mimar 	spoil (trodorloti)
mimoso 	affectionate, caressing, cuddle some, cuddly (karesema)
mineral 	mineral (mineralo)
ministerio 	ministry (ministrejo)
minuto 	minute (minuto)
miope 	near ? s i g h t e d, short ? s i g h t e d (miopa)
mirada 	look (rigardo)
mirlo 	blackbird (merlo)
misa 	mass (meso)
miserable 	miserable, poor (malri?a); abject, dismal, meager, miserable, wretched (mizera)
misericordia 	charity, merciful ness, mercy (kompatemo)
misericordioso 	charitable, merciful (kompatema)
mismo 	even (e?)
mito 	myth (mito)
mitra 	miter, mitre (mitro)
mobilario 	furniture (meblaro)
mochila 	backpack, knapsack (tornistro)
moda 	fashion, mode (modo)
moderno 	modern (moderna)
modesto 	modest (modesta)
modista 	milliner (modistino)
modo subjuntivo 	subjunctive (subjunktivo)
mofarse de 	laugh at (mokridipri)
mohoso 	mouldy (?ima)
mojado 	wet (malseka)
moler 	grind, pulverize (mueli)
molestar 	bother, disturb, hinder, trouble (?eni)
molestia 	hindrance (malhelpo); disquiet, disturbance, interference, unrest (perturbo); trouble (?eno)
momentito 	instant, moment (momento)
momento 	instant, moment (momento)
mondar habas 	string (senfadenigi)
moneda 	coin (monero)
monedas 	change (moneretamono)
monje 	monk (mona?o)
mono 	ape, monkey (simio); overalls (supertuto)
monopolio 	monopoly (monopolo)
monstruo 	colossus (koloso)
montar 	go in, enter, perform (eniri)
monte 	mountain (monto)
monumental 	monumental (monumenta)
morado 	violet (violkolora)
morar 	dwell, live (lo?i)
morder 	bite (mordi)
mordisco 	bite (mordo)
moreno 	brown (bruna)
morera 	mulberry ? t r e e (morusujo)
morir 	die, expire, pass away (morti)
mosaico 	mosaic, mosaic work (mozaiko)
mosca 	fly, housefly (mu?o)
mosquito 	mosquito (moskito)
mostaza 	mustard (mustardo)
mostrador 	counter (vendotablo)
mostrar 	indicate, point out, show (montri)
motel 	motel (motelo)
motivo 	inducement, occasion, motive (instigaka?zo); inducement, motive, occasion (instigaokaza?o); account, motive, reason (motivo)
moto 	motorcycle (motorciklo)
motocicleta 	moped (mopedo)
motor 	engine, motor (motoro)
moverse 	move (movi?i)
mozo 	porter (portisto)
muchacha 	girl, lass, wench (knabino)
muchacho 	boy, lad, laddie (knabo)
muchacho travieso 	naughty boy, pickle (buba?o)
mucho 	a lot of, much (multa); a lot of, much, plenty of (multeda)
mudar 	alter, change (alii?i); change, turn (?an?i)
mudo 	dumb, mute, speechless (muta)
mueblaje 	furniture (meblaro)
muelle 	spring (risorto)
muerte 	death (morto)
muerto 	dead (mortinta)
mujer 	wife (edzino); woman (virino)
mulo 	mule (mulo)
multa 	fine (monpuno); minutes, protocol (protokolo)
multar 	fine (monpuni); give a ticket, take somebody ' s n a m e (protokoli)
multiplicar 	multiply (multipliki); duplicate, multiply (multobligi)
mundo 	world (mondo)
municipio 	community (komunumo)
museo 	museum (muzeo)
muslo 	thigh (femuro)
muy 	quite, very, very much (tre)
nabo 	turnip (napo)
nacer 	arise, be born (naski?i)
nacimiento 	birth (naski?o)
nacional 	national (nacia)
nacionalidad 	nationality (nacieco)
nada 	nothing (nenio)
nadar 	float, swim (na?i)
nadie 	neither, nobody, none, no ? o n e (neniu)
naranja 	orange (oran?o)
naranjo 	orange ? t r e e (oran?arbo); orange ? t r e e (oran?ujo)
nariz 	nose (nazo)
nata batida 	whipped cream (batitakremo)
natural 	coming (devena)
naturaleza 	naturalmente 	naturally (nature)
navegar 	navigate (navigi)
necesario 	necessary (necesa)
necesidad 	need, want (bezono); necessity (neceseco)
necesitado 	abject, dismal, meager, miserable, wretched (mizera); miserable, needy (senhava)
necesitar 	need, require (bezoni)
neerlandesa 	Dutchwoman (nederlandanino)
negar 	deny (nei)
negativa 	refusal (rifuzo)
negativo 	negative (negativa)
negocio 	enterprise (entrepreno)
negro 	Negro (negro); black (nigra)
nene 	baby (bebo)
nervio 	nerve (nervo)
nevado 	snowy (ne?kovrita)
nevar 	snow (ne?i)
niebla 	fog, mist (nebulo)
nieto 	grandson (nepo)
nieve 	snow (ne?o)
ninguno 	neither, nobody, none, no ? o n e (neniu)
nivel 	level (nivelo)
ni mucho menos 	not at all (tutene)
no 	noble 	of noble birth (nobela)
nobleza 	nobility (nobelaro)
noche 	night (nokto); evening (vespero)
nogal 	walnut ? t r e e (juglandarbo); walnut ? t r e e (juglandujo)
nombramiento 	appointment, appointment to office (enoficigo)
nombrar 	appoint (enoficigi)
nombre 	appellation, name (nomo)
nombre de pila 	first name (anta?anomo)
normal 	normal (norma); normal (normala)
norte 	north, North (nordo)
noruega 	Norwegianwoman (norvegino)
noruego 	Norwegian (norvega); Norwegian (norvego)
nosotras 	us, we (ni)
nosotros 	us, we (ni)
nostalgia 	nostalgia (nostalgio)
notable 	considerable, sizable (konsiderinda)
notar 	note, make a note, write down (noti)
notario 	notary (notario)
noticia 	account, communication (komuniko); advice, announcement, communication, message, notice, report (sciigo)
noticias 	news, novelty, something new (nova?o); advice, announcement, communication, message, notice, report (sciigo)
notificar 	instruct, notify, summon (ordoniskribe)
notoriedad 	acquaintance, con vers ance, familiarity (konateco)
notorio 	well ? k n o w n (konata)
novela 	noviembre 	November (novembro)
novio 	beloved, loved one, lover, sweetheart, well ? b e l o v e d (amato)
no ... del todo 	not at all (tutene)
no ... mas 	no longer (neplu)
no ... mas que 	exclusively, just, only (nur)
no ... nunca 	never (neniam)
no tocar 	keep one ' s h a n d s o f f (netu?i)
nube 	cloud (nubo)
nudo 	knot, node (nodo)
nueve 	nine (na?)
nuevo 	new, novel (nova)
nuez 	nut (nukso)
nuez moscada 	nutmeg (muskato)
nunca 	never (neniam)
o 	or (a?)
oasis 	oasis (oazo)
obedecer 	obey (obei)
obispo 	bishop (episkopo)
objecto 	article, object, thing (objekto)
objeto 	thing (a?o); aim, goal, purpose, target (celo)
obligar 	compel, force (devigi)
obligatorio 	compulsory (deviga)
obra 	work (verko)
obrera 	female laborer, fema l labourer, fema l worker (laboristino)
obrero 	hand, laborer, labourer, operative, worker, workingman, workman (laboristo)
observar 	keep, mind, observe (observi)
obtener 	achieve, acquire, attain, get, obtain (akiri); get, have, receive (ricevi)
obtuso 	blunt (malakra); dull, obtuse (obtuza)
oca 	goose (ansero)
ocasionar 	activate, cause, give rise to (ka?zi); cause, cause to take place (okazigi)
occipucio 	back of the head, occ i put (okcipito)
ochenta 	eighty (okdek)
ocho 	eight (ok)
ochocientos 	eight hundred (okcent)
octavo 	eighth (oka)
octubre 	October (oktobro)
oculista 	oculist, oph tal mo logi st (okulisto)
ocultar 	conceal, hide (ka?i)
ocultarse 	hide, hide oneself (ka?isin)
oculto 	hidden (ka?ita)
ocupado 	busy (okupita)
ocupar 	occupy, take (okupi)
odiar 	hate (malami)
odio 	hate (malamo)
oeste 	west, West (okcidento); west (uesto)
ofender 	abuse, insult, offend (ofendi)
ofensa 	abuse, insult (insulto); abuse (ofendo)
oferta 	offer (oferto); presentation (prezentado); presentation (prezento)
oficial 	official (ofica); official (oficiala)
oficina 	bureau, office (oficejo)
oficina de correos 	postoffice (po?toficejo)
oficina de informaciones 	inquiry ? o f f i c e (informejo)
oficio 	handicraft, occupation, trade (metio); function, job, office, post (ofico)
oficioso 	accommodating, helpful (helpema)
ofrecer 	bid, offer, make an offer of (oferti)
ofrecimiento 	offer (oferto); presentation (prezentado); presentation (prezento)
ojo 	eye (okulo)
ola 	wave (ondo)
oleaje 	billow (ondego)
oler 	give of fan odour, reek, smell (odori)
oler a 	smell of (odorikiel)
oler mal 	reek, smell, smell bad, stink (fetori)
olivo 	olive ? t r e e (olivujo)
olla 	jug, pot (poto); jug, box, container, vessel (ujo)
olmo 	elm (ulmo)
olor 	aroma, flavour (aromo); odor, odour, scent, smell (odoro)
olvidar 	forget (forgesi)
omnipotencia 	omnipotence (?iopovo)
omnipotente 	almighty, all ? p o w e r f u l, omnipotent (?iopova)
omnisciente 	all ? k n o w i n g, omniscient (?ioscia)
once 	eleven (dekunu)
opio 	opium (opio)
oponerse 	confront, stand up to, withstand (kontra?stari); resist, withstand (rezisti)
oprimido 	stale (malfre?a); airless, oppressive, stiff ling, sultry (sufoka)
oprimir 	suppress (subpremi)
orden 	order (sinsekvo); warrant, writ (skribaordono)
ordenador 	computer (komputero)
orden por escrito 	warrant, writ (skribaordono)
oreja 	ear (orelo)
orgulloso 	proud (fiera)
origen 	lineage (deveno); beginning, commencement, start (komenci?o); origin (origino)
original 	aboriginal, original (origina); original (originala)
originario 	coming (devena)
orina 	urine (urino)
orinal 	pot, chamberpot (noktovazo)
orinar 	urinate (pisi); urinate (urini)
oro 	gold (oro)
ortiga 	nettle (urtiko)
oruga 	caterpillar (ra?po)
osa 	she ? b e a r (ursino)
oscuro 	dark, dim (malluma)
oso 	bear (urso)
ostra 	oyster (ostro)
otra vez 	afresh, again, all over again, a new (denove); afresh, again, once more (ree)
otro 	other, another, else (alia)
otro lado 	opposite side (transaflanko)
oveja 	sheep (?afo)
paciencia 	patience (pacienco)
padre 	padres 	parents (gepatroj)
padre y madre 	parents (gepatroj)
pagar 	pay (pagi)
pagar a plazos 	pay on account (pagiparte)
pago 	payment (pago)
paisaje 	landscape, scenery (pejza?o)
pala 	shovel (?ovelilo)
palabra 	word (vorto)
palacio 	palace (palaco)
palmera 	palm, palm tree (palmo)
palo 	baton, cane, stick (bastono)
paloma 	pigeon (palumbo)
pan 	bread, loaf (pano)
pana 	brake down (paneo)
panadero 	baker (bakisto)
panecillo 	roll (bulko)
panne 	brake down (paneo)
pantorrilla 	calf (suro)
papel 	paper (papero)
papel de cartas 	writing ? p a p e r (leterpapero)
papel pintado 	tapestry, wall covering (tapeto)
papel secante 	blotter, blotting paper (sorbapapero)
paquete 	packet, parcel (paketo)
par 	pair (duo); even (para); pair (paro)
para 	for, to, in order to, per (por)
parachoques 	buffer, bumper (bufro)
parada 	stop (haltejo)
paraguas 	umbrella (pluvombrelo)
paralelo 	parallel (paralela)
paraninfo 	auditorium (a?lo)
parar 	turn away (deturni); halt, come to a halt, stop (halti); halt, stop (haltigi); shut off, stop, switch off, turnoff (malfunkciigi)
para que 	so, so that (porke)
para una persona 	one person (unupersona)
parche 	adhesive plaster (diakilo)
pardo 	brown (bruna); grey (griza)
pardone usted 	excuse me (pardonu)
parecer 	appear, look (aspekti); appear, appear to be, seem (?ajni)
parecerse 	be similar, resemble (simili)
pared 	wall (muro)
pariente 	relative, female relative (parencino); relative (parenco)
parir 	bear, give birth to (naski)
parisiense 	Parisian (parizano)
parque 	park (parko)
parra 	vine, grapevine (vito)
parroquiano 	client, customer (kliento)
parte 	parte trasera 	back, reverse, reverse side (malanta?aflanko)
particular 	affair, business, business deal, case, matter (afero); apart, particular, separate, special (aparta)
partidario 	acolyte, member, supporter (ano); member, supporter (partiano)
partido 	adherents, disciples, following, party, supporters (anaro); adherents, disciples, followers, party members (partianoj); faction, party, side (partio); adherents, disciples, followers, following, party, supporters (sekvantaro)
pasada 	former, last, previous, prior (anta?a); last (pasinta)
pasado 	former (estinta); past (estinteco)
pasaporte 	passport (pasporto)
pasar 	pass, spend (pasigi)
pasillo 	corridor, passage (koridoro)
paso 	pass (montpasejo); gate, gangway, passage, passageway (pasejo); pace, step, stride (pa?o); passage (trairejo)
paso a nivel 	level ? c r o s s i n g (traknivelapasejo)
pasta de almendras 	almond paste (fran?ipano)
pastel 	baked goods (baka?o); pie, tart (torto)
pastelero 	confectioner (kukbakisto)
pastel de almendra 	al mound pastry (migdalkuka?o)
pastor protestante 	pastor (pastoro)
patada 	kick (piedbato)
patata 	potato (terpomo)
patillas 	whiskers, side ? w h i s k e r s (vangoharoj)
patinar 	skate (glitkuri); skate (sketi)
patinete 	scooter (skutilo); scooter (trotilo)
patio 	court, yard, courtyard (korto)
pato 	duck (anaso)
patria 	cradle, place of birth (naski?ejo); fatherland (patrujo)
patriarca 	patriarch (patriarko)
patrono 	patron (patrono)
pavo 	turkey (meleagro)
paz 	peace (paco)
pecho 	bosom, breast, chest (brusto)
pedal 	pedal (pedalo)
pedazo 	bit, lump, piece (peco)
pedido 	order (mendo)
pedir 	book, order, reserve (mendi); ask, ask for, beg, bid, request (peti)
pedir limosna 	beg (almozpeti)
pegar 	sew, sew on (alkudri); thrash (bategi); glue, stick (glui)
peinar 	comb (kombi)
peine 	comb (kombilo)
peligro 	danger, peril (dan?ero)
peligroso 	dangerous (dan?era)
pelota 	ball (pilko)
peludo 	hairy, hirsute (harkovrita)
peluquera 	hairdresser, female hairdresser (frizistino)
peluquero 	barber, hairdresser (frizisto)
pelvis 	basin, bowl, pelvis (pelvo)
pendiente 	ear ? d r o p, earring (orelpenda?o); pending (pritraktata)
pensamiento 	thought (penso)
pensar 	think (pensi)
pepino 	gherkin (kukumeto); cucumber (kukumo)
pera 	pear (piro)
peral 	pear ? t r e e (pirujo)
perca 	bass (perko)
perder 	miss (maltrafi); lose (perdi)
perderse 	lose one ' s w a y (vojerari)
perdida 	loss (perdo)
perdido 	lost (perdita)
perdiz 	partridge (perdriko)
perejil 	parsley (petroselo)
perfume 	perfume (parfumo)
periodista 	journalist, female journalist (gazetistino); journalist (gazetisto); journalist, female journalist (?urnalistino); journalist (?urnalisto)
perito de contabilidad 	accountant (kontrevizoro)
perjudicar a 	harm (malutili)
perla 	pearl (perlo)
permiso 	permission (permeso)
permitir 	accord, admit, afford, allow, permit (permesi)
pero 	but (sed)
perpetrar 	achieve, act, do, make, perform (fari); accomplish, achieve, keep, observe, perform (plenumi)
perro 	dog (hundo)
persa 	Persian (persa); Persian (perso)
perseguir 	chase, persecute, prosecute, pursue (persekuti)
persona 	person (persono)
personal 	personal (persona)
pertenecer a 	belong to (aparteni); belong to, be one of (estiunuel)
peruana 	Peruvianwoman (peruanino)
peruano 	Peruvian (perua); Peruvian (peruano)
pesado 	burdensome, heavy, onerous (peza)
pesar 	weigh (pezi)
pescador 	fisherman (fi?isto)
pescar 	fish (fi?i)
peso 	weight (pezo)
petroleo 	paraffin ? o i l, petroleum (petrolo)
petulancia 	wantonness (fipetolemo); wantonness (tumultemo)
petulante 	want on (fipetola); want on (tumultema)
pez 	fish (fi?o)
pez de colores 	goldfish (orfi?o)
pez dorado 	goldfish (orfi?o)
picar 	pick, stab, sting (piki)
pico 	beak, bill (beko); mountain peak, mountaintop, pinnacle (montsupro); woodpecker (pego)
pic nic 	picnic (pikniko)
piedra 	stone (?tono)
piel 	fur, hide, skin (felo); skin (ha?to); fur, fur coat, fur piece (pelto)
pierna 	leg (gambo); leg, paw (kruro)
piernas torcidas hacia afuera 	knock ? k n e e d l e g s, turned ? i n l e g s (ikskruroj)
pieza 	pijama 	pyjamas (pi?amo)
pila 	battery (pilaro)
pimienta 	pepper (pipro)
pimiento 	paprika (papriko)
pino 	pine, pine ? t r e e (pino)
pintar 	paint (pentri)
pintor 	painter (pentristo)
pintoresco 	picturesque (pitoreska)
pintura 	dye, paint (farbo); painting, picture (pentra?o)
piojo 	louse (pediko)
pipa 	pipe (pipo)
pirenaico 	Pyrenean (pirenea)
piscina 	pool, swimming ? b a t h, swimming ? p o o l (na?ejo)
piso 	apartment, flat (apartamento); floor, storey, story (eta?o)
piso bajo 	ground ? f l o o r (tereta?o)
placer 	pleasure (pla?o); fun, pleasure (plezuro)
plancha 	iron, flat ? i r o n (gladilo)
planchar 	iron, iron clothes (gladi)
plano 	even, flat, level, smooth (ebena); map (mapo); design, diagram, plan, plane (plano)
planta 	sole (plando); plant (planto)
plantar 	plant (planti)
plata 	silver (ar?ento)
plataforma 	platform (vagoneniravestiblo)
plataforma posterior 	rear platform (malanta?aplatformo)
platija 	plaice (plateso)
platillo 	cymbal (cimbalo); saucer (subtaso)
plato 	food (man?a?o); menu (menuo); plate (telero)
playa 	beach (pla?o)
plaza 	plaza, square, public square (placo)
plaza de toros 	bullring (ta?robatalaareno); bullring (ta?robatalejo)
pleito 	complaint (plendo)
plemear 	plombo 	lead (plumbo)
pluma 	pobre 	miserable, poor (malri?a); abject, dismal, meager, miserable, wretched (mizera); poor (povra); miserable, needy (senhava)
pobreza 	poverty (malri?eco)
pobrezo 	misery (mizero)
poco 	a little, rather, some, somewhat, to some extent (iom); a little, rather (iomete); little (malmulta)
poco a poco 	gradually, little by little (iompostiom)
podadera 	bill, pruning ? k n i f e (bran?otran?ilo)
podadera de mango largo 	pole prune r (bran?tondilego)
podadera de mano tipo yunque 	anvil prune r (ambosabran?tondilo)
podadera de vanilla 	pole prune r (bran?tondilego)
poder 	be able to (povi); ability (povo)
podrido 	addled, bad, rotten (putra)
polaca 	Polishwoman (polino)
polaco 	Polish (pola); Pole (polo)
polaina 	gaiter, legging (tibiingo)
pollo 	chick, chicken (kokido)
polonesa 	Polishwoman (polino)
polvo 	dust (polvo)
polvos 	powder, cosmetic powder (pudro); powder (pulvoro)
pomelo 	grapefruit (grapfrukto)
poner 	put on, start, switch on, turn on (ekfunkciigi); turn on (en?alti); lay (ku?igi); lay down, place, put, put down (meti)
ponerse 	attitudinize, pose, put on airs (afekti); put on (surmeti); dress, get dressed (vesti?i); dress (vestisin)
poner pleito a 	sue (procesikontra?)
poney 	pony (poneo)
popa 	poop, poop deck, stern (pobo); stern (postasteveno); poop, poop deck, stern (po?po)
poquito 	a little, rather (iomete)
por 	a, in, inside, into, on, per, within (en); a, per (po?); through (tra)
porciento 	percent, percentage (procento)
porque 	because, for the reason that (protioke); because, for the reason that (tialke); as, because, for, since (?ar)
portamonedas 	purse, wallet (monujo)
portero 	porter (pordisto)
portuguesa 	Portuguesewoman (portugalino)
porvenir 	future (estonteco)
por ejemplo 	for example, for instance (ekzemple)
por eso 	on that account, therefore (protio); on that account, therefore (tial)
por favor 	please (bonvolu)
por fin 	at last, finally, ultimately (fine)
por fortuna 	fortunately (bon?ance); unfortunately (feli?e)
por la derecha 	right, to the right (dekstren)
por la izquierda 	left, to the left (maldekstren)
por la noche 	in the evening (vespere)
por la tarde 	in the evening (vespere)
por lo tocante a 	about, concerning (koncerne); about, concerning, on, upon (pri); as to, as regards, concerning (rilate)
por medio de 	by, by means of, on, through, with (per)
por separado 	apart, separately (aparte)
por suerte 	by accident, by chance (hazarde)
poseer 	own, possess (posedi)
posible 	possible (ebla)
postal 	picture postcard (bildkarto); postcard (po?tkarto)
poste 	pole, post, stanchion, stake (fosto)
postre 	dessert (deserto)
postrero 	last (lasta)
practicable 	passable, practicable (irebla); passable, practicable (surirebla)
precavido 	careful, cautious (singarda); careful, cautious (singardema)
precio 	price (prezo)
precio de entrada 	admission, admission fee (enirpago)
precipicio 	abyss, chasm, gulf, precipice (abismo)
precipitadamente 	hastily, hurriedly, in a hurry (haste)
preciso 	accurate, precise (preciza); correct, exact, proper, right (?usta)
preferir 	prefer (preferi)
pregunta 	question (demando)
preguntar 	ask (demandi)
preguntarse 	ask oneself, wonder (demandialsi)
prejuicio 	prejudice (anta?ju?o)
premiar 	award a prize (premii)
preocupar 	agitate, alarm (maltrankviligi)
preparar 	prepare (prepari)
presa 	dam (bara?o)
presencia 	presence (?eesto)
presente 	present (?eestanta)
preservativo 	condom, rubber (kondomo)
prestar 	borrow (pruntepreni); borrow, lend, loan (prunti)
preste 	priest (sacerdoto)
presumido 	attitudinize r, poseur (afektulo)
presupuesto 	budget, estimate, estimates (prezkonjekto)
pretina 	prever 	foresee (anta?vidi)
prima 	cousin (kuzino)
primavera 	spring, springtime (printempo)
primeramente 	first, firstly, first of all (unue)
primero 	first (unua); first, firstly, first of all (unue)
primeros socorros 	first aid (sukurismo); first aid (unuahelpo)
primitivo 	initial (komenca)
primo 	cousin (kuzo)
primo segundo 	second cousin (prakuzo)
princesa 	princess (princino)
principal 	most important (plejgrava); main, predominant, principal (precipa); chief, main, major, principal (?efa)
principalmente 	above all, especially, chiefly, mainly, principally (precipe); chiefly (?efe)
principiante 	beginner (komencanto)
principiar 	begin, commence, start (komenci?i)
principio 	beginning, commencement, start (komenci?o); beginning, commencement, start (komenco); principle (principo)
prisa 	haste (hasto); speed (rapideco); urgency (ur?eco)
privar 	rob (prirabi)
probablemente 	probably (ver?ajne)
probar 	attempt, test, try (provi); prove (pruvi); try on (surprovi); try on (vestiprove)
procedente de 	a native of, coming from (devenade)
proceso 	action, lawsuit (proceso)
proceso verbal 	minutes, protocol (protokolo)
proclamar 	issue, proclaim (proklami)
procurarse 	achieve, acquire, attain, get, obtain (akiri); buy, get, procure (havigialsi); buy, get, procure (provizisinper)
producir 	activate, cause, give rise to (ka?zi); afford, bear, produce (produkti)
producto 	product (produkto)
profesional 	professional (profesia)
profundidad 	depth (profundo)
profundo 	deep, profound (profunda)
progreso 	advance, advancement, progress (progreso)
prohibir 	forbid, prohibit (malpermesi)
prohijar 	affiliate (filiigi)
promesa 	affirmation, promise (promeso)
prometer 	promise (promesi)
prometida 	prometido 	promulgar 	issue, proclaim (proklami)
pronombre demonstrativo 	demonstrative, demonstrative pronoun (demonstrativo); demonstrative, demonstrative pronoun (montrapronomo)
pronto 	soon (balda?); fast, quickly, swiftly (rapide)
pronunciar 	pronounce (elparoli); pronounce (prononci)
propiedad 	ownership (proprieto)
propietario 	owner (proprietulo)
propina 	tip (trinkmono)
propio 	own, personal (propra)
prostituta 	prostitute (prostituitino)
protectar 	protect (protekti)
protector 	patron (protektanto)
proteger 	protect (protekti)
protegido 	protesta 	protest (protesto)
protestante 	Protestant (protestanta)
protestar 	protest (protesti)
provecho 	benefit, gain, profit (gajno); gain, profit (profito); advantage, benefit (utilo)
proveniente 	coming (devena)
provisionalmente 	for the time being, temporarily (provizore)
proyectar 	make a project of, plan (projekti)
prudente 	thoughtful (anta?zorga); careful, cautious (singarda)
prueba 	problem, trouble (problemo); proof, sign, token (pruvo)
prusiano 	Prussian (prusa); Prussian (pruso)
psiquiatra 	psychiatrist (psikiatro)
publicar 	advertise, announce, give notice (anonci); publish, reveal (publikigi); acquaint, let know, in form (sciigi)
pueblecito 	hamlet, township (vila?eto)
pueblo 	folk, nation, people (popolo); village (vila?o)
puente 	bridge (ponto)
puerta 	gate, gateway, portal (pordego); door (pordo)
puerta trasera 	back ? d o o r (malanta?apordo)
puerto 	harbor, harbour, port (haveno)
puesta del sol 	sunset (sunsubiro)
puesto 	barn, shed, stand (budo)
puesto de Primeros Auxilios 	first ? a i d s t a t i o n (sukurejo)
puesto que 	because, for the reason that (protioke); because, for the reason that (tialke); as, because, for, since (?ar)
pulga 	flea (pulo)
pulgar 	thumb (dikfingro); thumb (polekso)
pulsera 	bracelet (braceleto); bracelet (?irka?brako)
punta 	peak, point, tip, summit (pinto)
puntiagudo 	pointed, spiked (pinta)
punto 	dot, period, point, spot (punkto)
punto de contacto 	starting point (komencloko)
punto de partida 	starting point (deirpunkto)
punto inicial 	starting point (deirpunkto)
purgante 	laxative (laksigilo)
puro 	pus 	pus (puso)
puta 	hooker, whore (putino)
que 	that (ke); than (ol)
quebraja 	crack, crevice (fendo); burst, crack, flaw (kreva?o)
quebrar 	break (rompi)
quedar 	meet (rendevui); be situated (situi)
quedarse 	remain, stay, stay over (resti)
queja 	complaint (plendo)
quejarse 	complain (plendi)
quemado 	burnt (brulgusta)
quemar 	burn (bruligi); be burnt down (forbruli); burn down (forbruligi)
quemarse 	stick to the pan (brulglui?i)
queque 	cake (kuko)
querer 	love (ami); desire, wish (deziri)
querer decir 	aim, intend (celi); mean (volidiri)
querido 	beloved, loved one, lover, sweetheart, well ? b e l o v e d (amato); best (plejbona)
queso 	cheese (froma?o)
quieto 	calm, quiet (kvieta)
quince 	fifteen (dekkvin)
quinto 	fifth (kvina); fifth (kvinono)
quitar 	abstract, take away (forpreni)
quitarse 	takeoff, put off (demeti); absent on self, depart, go away, leave (foriri)
quitar el polvo 	dust (senpolvigi)
quitar el polvo a 	dust (senpolvigi)
radiador 	radiator (radiatoro)
radio 	ralea 	property, quality (kvalito)
rama 	bough, branch (bran?o)
rana 	frog (rano)
raramente 	seldom (malofte)
raro 	rare (malofta)
rascar 	scratch (grati)
rata 	rat (rato)
raya 	ray, strip, stripe (strio)
rayo 	rayos x 	X?rays (iksradioj)
raza 	breed, race (raso)
razonable 	acceptable (akceptinda)
reaccionar 	react, respond (reagi)
realizar 	accomplish, achieve, act out (efektivigi); produce (realigi)
realizarse 	come about, happen, occur (okazi)
rebaja 	abatement, discount, rebate (rabato)
rebanada 	bread and butter (buterpano)
rebuznar 	bray (iai)
recado 	errand, message (mesa?o)
recalar 	end up (finveni)
recelo 	suspicion (malfido); suspicion (suspekto)
recelocaz 	suspicion (suspekto)
receloso 	suspicious (malfida); suspicious (malfidema); suspicious (suspektema)
receta 	prescription, recipe (recepto)
rechazar 	reject (malakcepti); reject (malakceptivo?done); refuse, reject (rifuzi)
recibir 	get, have, receive (ricevi)
recibo 	receipt (kvitanco); acknowledgement, receipt (ricevatesto)
recientemente 	recently (fre?date)
recipiente de agua 	basin, reservoir (baseno)
recitar 	recite (reciti)
recoger 	collect, gather, pickup (kolekti); get, lay hold of, pickup, take (preni)
recoger la mesa 	clear away, remove the cloth (forigilaman?ilaron)
recomendable 	recommend able (rekomendinda)
recompensa 	compensation, reward (rekompenco)
recompensar 	compensate, reward (rekompenci)
recorrer 	cover, go through, pass through (trairi)
recuerdo 	keepsake, memento, souvenir (memora?o); keepsake, memento, souvenir (memoriga?o); memory, recollection (memoro); recollection (rememoro)
red 	net, network (reto)
redicho 	hackneyed (gurdita); hackneyed, hard ? w o r k e d, stale, trite, worn ? o u t (tedebanala)
redondear 	round, roundoff (rondigi)
redondel 	arena (areno)
redondo 	round (ronda)
reflexionar 	think, think about, reflect on (pripensi)
reflujo 	low tide (refluo)
refrenar 	control, govern, restrain, rule (regi)
refugio 	asylum (azilo); Alpinehut, climber ' s h u t, mountain hut (montkabano)
regalo 	gift, present (donaco); gift (dona?o)
regar 	irrigate, water (akvumi); water (surver?i)
registrar 	examine (ekzameni); audit, check, checkup on, supervise, verify (kontroli); record, register (registri)
registro 	account book, record, register (registro)
regla 	regulation, rule (regulo)
reglamento 	regulations, rules (regularo)
rehusar 	reject (malakcepti); refuse, reject (rifuzi)
reina 	queen (re?ino)
reino 	kingdom (re?lando)
reja 	barrier, fence (barilo)
relampaguear 	lighten (fulmi)
relevar 	take the place of (anstata?i)
relevo 	replacement, substitution (anstata?o)
relleno 	replacement, replenishment, supplement (kompletigo)
reloj 	watch (horlo?eto); clock, watch (horlo?o)
relojero 	watchmaker (horlo?isto)
reloj de pulsera 	watch, wrist ? w a t c h (brakhorlo?o)
remar 	row (remi)
remendar 	mend, patch, patch up (fliki)
remitente 	sender (ekspedinto); sender (sendinto)
remo 	oar (remilo)
remolacha 	beet (beto)
remolcar 	drag, tow (treni)
remolque 	trailer (postveturilo)
renegado 	unfaithful (malfidela)
renunciar a 	relinquish, renounce, waive (rezignipri)
reparar 	fix, repair (ripari)
reparo 	criticism (kritiko); observation, remark, reproof (malla?do); observation, remark (ripro?arimarko)
repeler 	protect from, ward off (?irmisinkontra?)
repetir 	repeat (rediri); repeat (ripeti)
reponerse 	revive (revivi?i)
reprender 	reproach, rebuke, reprove, scold (malla?di); blame, rebuke, reproach, reprove, scold (ripro?i)
representante 	agent (agento)
representante exclusivo 	sole agent (solaagento)
representar 	act for, represent (reprezenti)
reprimir 	bridle, check, restrain (bridi); control, govern, restrain, rule (regi)
reprobable 	blameworthy, c en sur able, condemn able, objectionable (malaprobinda)
reprobar 	condemn, disapprove, disapprove of, rebuke (malaprobi); reproach, rebuke, reprove, scold (malla?di); blame, rebuke, reproach, reprove, scold (ripro?i)
reproducir 	depict, represent (figuri)
repugnancia 	a version, dislike (antipatio); disgust, nausea (na?zo)
repulsar 	reduce the price (rebati)
requerir 	admonish, scold (admoni)
resabio 	habit, trick (alkutima?o)
reservar 	reserve (anta?mendi); reserve (rezervi); book (rezervigi)
resfriado 	cold (malvarmumo); cold (nazkataro)
resistir 	resist, withstand (rezisti)
resolver 	decide (decidi)
respaldo 	prop, support (apogilo)
respectar 	esteem, think well of (estimi)
respecto de 	about, concerning (koncerne); about, concerning, on, upon (pri); as to, as regards, concerning (rilate)
respetable 	respectable (estiminda)
respetar 	respect (respekti)
respirar 	exhale (elspiri); breathe (spiri)
responder 	answer, reply, respond (respondi)
responder a 	answer (respondial)
responsabilidad 	responsibility (respondeco)
responsable 	accountable, responsible (responda); accountable, responsible (respondeca)
respuesta 	answer, reply (respondo)
resquebrajarse 	burst, split (fendi?i); burst (krevi)
restar 	remain, stay, stay over (resti)
restaurante 	restaurant (restoracio)
resultado 	result (rezulto)
resultar 	point out to be (montri?i)
resumen 	retaguardia 	rear, rear guard (ariergardo); defence, rear, rear guard (postgvardio)
retener 	detain, hold back, retain (reteni)
retirarse 	retreat (retiri?i)
retiro 	isolation, separation (izoliteco)
retraso 	delay, retardation (malfrui?o); adjournment, delay (prokrasto)
retratar 	depict, represent (figuri)
retrato 	image, picture (bildo); figure, diagram, image, picture, representation (figuro)
retrete 	toilet (necesejo)
retroceder 	go back, go backwards (posteniri)
retroceso 	decline, going down (regreso)
retrovisor 	driving mirror (retrospegulo)
reumatismo 	rheumatism (re?matismo)
reunir 	join, unite (kunigi); join, unite (unuigi)
reunirse 	join (ali?i)
revelar 	develop, reveal (riveli)
reverso 	back, reverse, reverse side (dorsflanko)
revisar 	examine (ekzameni); audit, check, checkup on, supervise, verify (kontroli); revise (revizii)
revisor 	guard (konduktoro)
revista 	periodical (periodagazeto); magazine, periodical, revue (revuo)
rey 	king (re?o)
rezagado 	laggard, straggler (postrestanto)
rezar 	pray (pre?i)
rico 	nice, tasty (bongusta)
ridiculizar 	ridicule (ridindigi)
riesgo 	hazard, risk (risko)
rigido 	rigid, stiff (rigida)
rinceronte 	rhino, rhinoceros (rinocero)
riqueza 	abundance, affluence, wealth (ri?eco)
risa 	laughter (ridado)
ritmo 	rhythm (ritmo)
robar 	rob (pri?teli); steal (?teli)
roble 	oak (kverko)
robo 	abstraction, theft (?telo)
roca 	reef (rifo); rock (roko)
rodar 	roll (ruli)
rodilla 	knee (genuo)
rojo 	romano 	romper 	break (rompi)
ron 	rum (rumo)
roncar 	snore (ronki)
ropa 	clothes, clothing (vestoj)
ropa de la cama 	bed ? c l o t h e s, bedding (lita?o)
rosa 	rose (rozo)
rosado 	pink (rozkolora)
rostro 	face (viza?o)
roto 	broken (rompita)
rubio 	blond, fair (blonda)
rueda posterior 	back wheel, hind wheel, rear wheel (malanta?arado)
ruego 	appeal, entreaty, supplication (petego)
ruido 	a do, d in, noise (bruo); sound (sono); agitation, riot, tumult (tumulto)
ruina 	ruin (ruino)
rumano 	Romanian, Rumanian (rumana); Romanian (rumano)
rusa 	Russianwoman (rusino)
ruso 	Russian (rusa); Russian (ruso)
ruta 	route (itinero); route (vojplano)
saber 	know, knowhow (scii)
sabido 	well ? k n o w n (konata)
saborear 	taste (gustumi)
sacacorchos 	corkscrew (korktirilo)
sacerdote 	priest (sacerdoto)
salario 	salary, wage, wages (salajro)
saldar 	liquidate (likvidi); pay (pagi)
salida 	demand, sale (debito); exit, way out (elirejo); departure (forveturo)
salida del sol 	sunrise (sunlevi?o)
salir 	exit, go out (eliri); absent on self, depart, go away, leave (foriri); drive away, drive off (forveturi)
salmo 	psalm (psalmo)
salsa 	gravy, sauce (sa?co)
salsa de malzanas 	apple ? s a u c e (pomka?o)
salsa de manzanas 	apple ? s a u c e (pomkompoto)
saltamontes 	grasshopper, locust (akrido)
saltar 	jump, leap, spring (salti)
salteo 	assault (atenco)
salto 	jump, leap (salto)
salud 	health (sano)
saludar 	greet, salute (saluti)
saludo 	greeting, salutation (salutado); greeting (saluto)
salvar 	keep, save, rescue (savi)
salvia 	sage (salvio)
salvo 	bar, barring, except for, subject to, without prejudice (kunrezervopri)
sanar 	recover (resani?i)
sandalia 	sandal (sandalo)
sandwich 	sandwich (sandvi?o)
sangrar 	bleed (sangellasi)
sangre 	blood (sango)
santa 	saint (sanktulino)
santo 	saint (sanktulo)
sapo 	toad (bufo)
saque de comienzo 	kick ? o f f (ekludo)
sastre 	tailor (tajloro)
sauce 	willow (saliko)
secar 	dry (sekigi)
seco 	dry (seka)
secreto 	hidden (ka?ita); secret (sekreta)
secta 	sect (sekto)
sed 	thirst (soifo)
seducir 	attract, draw (allogi)
segregar 	divide, separate (apartigi)
seguido 	directly, stra i gh ahead (rekte); straight ahead, straight along (rekteanta?en)
seguir 	follow (sekvi)
segundo 	second (dua); second (sekundo)
seguridad 	safety, security (sekureco)
seguro 	insurance (asekuro); safe, secure (sekura)
seis 	six (ses)
sellar 	mark, stamp (stampi)
sello 	stamp, postage stamp (po?tmarko)
sello de correos 	stamp, postage stamp (po?tmarko)
semanalmente 	weekly (?iusemajne)
sembrar 	sow (semi)
semejante 	like, a like, similar (simila)
sencillo 	simple, straightforward (simpla)
sendero 	path (vojeto)
sensible 	sensitive (sentiva)
sentarse 	s it down (eksidi); s it down (sidi?i)
sentencia 	decision, judgement (ju?adecido)
sentimiento 	feel, feeling, sensation (sento)
sentir 	be sorry about, regret (beda?ri); feel, sense (senti)
sentirse 	feel (sentisin)
separado 	apart, particular, separate, special (aparta); remote (izolita)
separar 	divide, separate (apartigi)
septiembre 	September (septembro)
ser 	sereno 	serene, untroubled (serena)
serie 	series, set (serio)
serio 	earnest, serious, staid (serioza)
serpiente 	serpent, snake (serpento)
servicial 	accommodating, helpful (helpema)
servicio 	service, worship service (diservo); attendance, service, waiting (servado); house charge, service charge (servamono); service (servo)
servilleta 	napkin (bu?tuko)
servir 	accomodate (fariservon); serve (servi); serve (surtabligi)
ser arrojado a la playa 	be washed ashore (alna?i); be washed ashore (surbordi?i)
ser de 	belong to (aparteni)
ser partidario de 	adhere to (estiadeptode)
ser presuntuoso 	attitudinize, pose, put on airs (afekti)
sesenta 	sixty (sesdek)
seta 	fungus, mushroom (fungo); mushroom (?ampinjono)
severo 	severe, strict (severa)
sexo 	sex (sekso)
sexto 	sixth (sesa)
sexual 	generative, sexual (seksa)
si 	siberiana 	Siberian (siberia)
siberiano 	Siberian (siberiano)
sidra 	cider (cidro)
siempre 	constantly, continually, continuously (da?re); always, ever (?iam)
sien 	temple (tempio)
sierra 	mountain chain (montaro); chain of mountains, mountain chain, mountain range, rand (monto?eno); saw (segilo)
siete 	seven (sep)
siglo 	centennial, century (jarcento)
significar 	imply, mean, signify (signifi)
siguiente 	following, next (sekvanta)
silbar 	whistle (fajfi)
silencio 	calm, quiet, silence (kvieto); silence (silento)
silla 	chair (se?o)
simple 	simple, straightforward (simpla)
sin 	without (sen)
sincero 	above ? b o a r d, honest (honesta); above ? b o a r d, sincere (sincera)
sin aliento 	breathless (senspira)
sin duda 	no doubt, undoubtedly (sendube)
sistema 	system (sistemo)
sitiar 	besiege (sie?i)
sitio 	place (ejo); location, place, spot (loko); seat (sidejo); siege (sie?o)
sobre 	envelope (koverto); on, upon (sur)
sobretodo 	above all, especially, chiefly, mainly, principally (precipe); chiefly (?efe)
sobre todo 	above all, especially (anta??io)
sobrino 	nephew (nevo)
sofocar 	choke, quell, suffocate, suppress (sufoki)
sol 	sun (suno)
solicitar 	ask, ask for, beg, bid, request (peti)
solicitud 	request (peto)
sollo 	sturgeon (sturgo)
solo 	alone, only, sole, solitary (sola)
soltero 	single, unmarried (fra?la)
solterona 	sombra 	sombrero 	hat (?apelo)
somero 	shallow, superficial (malprofunda)
sonido 	sound (sono)
sonrisa 	smile (rideto)
sopa 	soup (supo)
soplar 	blow (blovi)
sordo 	deaf (surda)
sorprender 	surprise (surprizi)
sorpresa 	surprise (surprizo)
sosegado 	calm, tranquil (trankvila)
sosegar 	appease, calm, quiet, soothe, still (trankviligi)
sosegarse 	abate, subside (kvieti?i); calm down (trankvili?i)
sospecha 	suspicion (malfido); suspicion (suspekto)
sospechar 	suspect (suspekti)
sostener 	abet, support, sustain (subteni)
su 	her, his, its, their (sia); her (?ia)
subasta 	tender (prezkonkurado)
subir 	ascend, getup, go up, lift, rise, arise (levi?i); ascend, climb, go up (supreniri)
subir a 	ascend, climb, scale (surgrimpi)
subscriptor 	subscriber (abonanto)
substantivo 	noun, substantive (substantivo)
substituir 	take the place of (anstata?i); replace, substitute (anstata?igi)
subyugar 	govern, head up, restrain (estri); control, govern, restrain, rule (regi)
sucesivamente 	consecutively (sinsekve)
sucesivo 	following, next (sekvanta)
sucinto 	concise (konciza)
sucio 	dirty, filthy, nasty, soiled, unclean (malpura)
sudafricano 	SouthAfrican (sudafrika)
sudamericano 	SouthAmerican (sudamerika)
sudar 	sweat (?viti)
sudor 	perspiration, sweat (?vito)
sueco 	Swedish (sveda); Swede (svedo)
suela 	sole (plandumo)
suelo 	bottom, foundation, ground (fundo); floor (planko)
suelto 	loose (nefiksita)
suerte 	destiny, fate, fortune, luck (sorto); kind, sort (speco); chance, luck (?anco)
suizo 	Swiss (svisa); Swiss (sviso)
sujetador 	bra (mamzono)
sujetar 	hang on to, hold (teni)
suma 	amount, sum (sumo)
sumar 	add up, sum up (sumigi)
superficie 	summit, surface, top (supra?o)
supermercado 	supermarket (memservavendejo); supermarket (supermarkto)
suplemento 	replacement, replenishment, supplement (kompletigo)
suplicar 	implore, invoke (elpetigi)
suponer 	guess, presume, suppose, surmise (supozi)
sur 	south (sudo)
surtido 	assortment (sortimento)
suscribirse 	subscribe, subscribe to (ekaboni)
suscriptor 	subscriber (abonanto)
suspender 	reject (malakcepti)
suspicaz 	suspicious (malfida); suspicious (malfidema); suspicious (suspektema)
suspirar 	sigh (suspiri)
sustraer 	subtract (subtrahi)
tabaco 	tobacco (tabako)
taberna 	bar, pub (drinkejo)
tabique 	wall (vando)
tabla 	shelf (breto); lath, slat (lato); board, plank (tabulo)
tabla de planchar 	ironing board (gladotabulo)
taburete 	bars tool (trinkejatabureto)
taco 	nail (najlo); taco (tako)
tajada 	slice (tran?a?o)
tal 	such, such a, that kind of (tia)
talento 	aptitude, disposition, talent, turn (naturdoto)
talentoso 	gifted, talented (naturdotita); accomplished, talented (talenta); gifted, talented (talentplena)
taller 	workplace (laborejo)
talonario 	cheque ? b o o k (?ekaro)
tal vez 	maybe, may hap, perchance, perhaps, possibly (eble)
tambor 	drum (tamburo)
tampoco 	neither, nor (nek)
tanque 	cistern, tank (cisterno); tank (rezervujo)
tantico 	a little, rather (iomete)
tanto 	that much (tiom)
tapacubo 	hub ? c a p (nabo?apo)
tapicero 	paper er, paper ? h a n g e r (tapetisto)
tapizar 	paper (tapeti)
tapon 	hub ? c a p (nabo?apo)
taquilla 	window, ticket ? w i n d o w (gi?eto)
tardar 	be kept in, be detained, remain, stay on (postresti)
tarde 	afternoon (posttagmezo); evening (vespero)
tarjeta 	card, map, menu (karto); postcard (po?tkarto)
tarjeta postal 	picture postcard (bildkarto); postcard (po?tkarto)
tarjeta postal ilustrada 	picture postcard (bildkarto); picture postcard (ilustritapo?tkarto)
tarta de manzana 	apple ? t a r t (pomtorto)
tasa 	assessment (impostkvoto)
taxi 	taxi (taksio)
taza 	cup (taso)
teatro 	theatre (teatro)
tejado 	roof (tegmento)
tela 	bit, lump, piece (peco); cloth, material (?tofo)
telegrama 	telegram (telegramo)
telemando 	remote control (telefunkciigo)
temer 	be afraid of, fear (timi)
temeroso 	afraid (malkura?a); afraid (tima); horrible (timiga)
temor 	fear (timo)
temperatura 	temperature (temperaturo)
tempestad 	storm (?tormo)
templo 	temple (templo)
temporada 	season (sezono)
temprano 	early (frue)
tenazas 	pincers (pin?tenajlo); tongs (prenilo); pincers, pair of pincers (tenajlo)
tenedor 	fork (forko)
tenedor de libros 	book ? k e e p e r (librotenisto)
tener 	desire, wish (deziri); have, have got (havi); own, possess (posedi); hang on to, hold (teni)
tener cuidado 	advert, pay attention, pay attention to, watch out for (atenti)
tener lugar 	come about, happen, occur (okazi)
tener puesto 	wear (surhavi)
tener que 	have to, must, ought to, should (devi)
tenga 	behold, here is, here are, look, there (jen)
tenis 	tennis (teniso)
tercero 	third (tria)
tercio 	third (triono)
terciopelo 	velvet (veluro)
terminado 	completed, done, finished, over, through (finita)
terminante 	effective, effectual, efficacious (efika)
terminar 	accomodate, end, finish, terminate (fini)
terminarse 	end, come to an end, end up, expire (fini?i)
termos 	thermos bottle (termoso); thermos, thermos flask (varmbotelo)
ternero 	calf (bovido)
terraza 	terrace (teraso)
terremoto 	earthquake (tertremo)
terrenal 	terrestrial (surtera); earthen, earthly, terrestrial (tera); terrestrial (tergloba)
terreno 	ground, grounds, terrain (tereno)
terreno del camping 	camping ground, camping site (kampadejo)
terreno pantanoso 	marsh, swamp (mar?o)
terrestre 	terrestrial (surtera); earthen, earthly, terrestrial (tera); terrestrial (tergloba)
testigo 	witness (atestanto)
tetera 	teapot (tekru?o); tea ? p o t (teujo)
texto 	lyric, text (teksto)
tibio 	lukewarm (varmeta)
tiempo 	time, while (tempo); weather (vetero)
tienda 	boutique, shop, store (butiko)
tierno 	soft (mola)
tierra 	earth, land, soil (tero)
tigre 	tiger (tigro)
tijeras 	scissors (tondilo)
tijera para setos 	hedge clippers, hedges hears (he?tondilo)
tilo 	lime ? t r e e, linden ? t r e e (tilio)
timbrar 	mark, stamp (stampi)
timbre 	bell (sonorilo); bell (tintilo)
timbre de alarma 	alarm bell (alarmsonorilo)
tinieblas 	darkness, murk (mallumo)
tinta 	ink (inko)
tirantes 	braces, suspenders (?elkoj)
tirar 	fire, shoot (pafi); drag, draw, haul, pull, tug (tiri)
titubear 	hesitate (heziti); hesitate, waver (?anceli?i)
toalla 	towel (mantuko)
tobillo 	ankle (maleolo)
tocar 	tocino 	bacon (lardo)
todavia 	still, yet (ankora?)
toda clase de 	all, every kind of (?ia); all sorts, all sorts of, miscellaneous, of all sorts (?iuspeca)
todo 	entire, overall, whole (tuta); all, altogether, everything (?io)
todopoderoso 	almighty, all ? p o w e r f u l, omnipotent (?iopova)
todos 	all (?iuj)
tolerar 	endure, put up with, tolerate (toleri)
tomar 	accept, receive, take, take in (akcepti); engulf, swallow up (engluti); get, lay hold of, pickup, take (preni)
tomate 	tomato (tomato)
tomo 	volume (volumo)
toque 	touch (ektu?maniero); touch (fingrofrapo)
torcido 	furious (kolerega)
tormenta 	storm (?tormo)
tornillo 	screw (?ra?bo)
toro 	bull (ta?ro)
torre 	castle, tower (turo)
torta 	pie, tart (torto)
tortilla 	omelette (omleto)
toser 	cough (tusi)
trabajador 	hand, laborer, labourer, operative, worker, workingman, workman (laboristo)
trabajar 	work (labori)
trabajo 	job, work (laboro)
traducir 	translate (traduki)
traer 	bring, fetch (alporti)
tragar 	engulf, swallow up (engluti); swallow (gluti)
traje 	costume, outfit, suit (kostumo)
tranquilo 	calm, tranquil (trankvila)
transbordador 	ferry (pramo)
transitable 	passable, practicable (irebla); passable, practicable (surirebla)
transitivo 	transitive (transitiva)
transpirar 	sweat (?viti)
transportar 	transport (transporti)
transporte 	transport (transporto)
tras 	behind, after (malanta?)
trasladar 	copy (kopii)
traslado 	copy (kopio)
trasporte 	transport (transporto)
trastornar 	overthrow, turn, turnover, upset (renversi)
tratado 	treaty (traktato)
tratamiento 	treatment (manipulado); treatment (pritraktado); treatment (traktado)
tratar 	treat (pritrakti); deal with, handle, treat (trakti)
tratar de 	aim, attempt, endeavour, take steps, undertake (klopodi)
trato 	treatment (traktado)
trece 	thirteen (dektri)
treinta 	thirty (tridek)
tremblar 	quiver, shiver, tremble (tremi)
tren 	train (trajno); train (vagonaro)
tren corrido 	corridor train (D?trajno)
trepar 	climb (grimpi)
tres 	three (tri)
tresillo 	lounge suite, three ? p i e c e s u i t e (benkse?aro)
tres veces 	three times, thrice (trifoje)
tributo 	tax (imposto); tribute (tributo)
tricar 	carrier cycle, carrier tricycle (transportbiciklo)
trigo 	wheat (tritiko)
trillado 	hackneyed (gurdita); hackneyed, hard ? w o r k e d, stale, trite, worn ? o u t (tedebanala)
trinquete 	clique, coterie, jun to, set (kliko)
triste 	sad (afliktita); bleak, dismal, dreary, gaunt, miserable, sad, somber (malgaja); dismal, gaunt, miserable, sad (mal?oja)
tristeza 	sadness, sorrow (mal?ojo)
trivial 	commonplace, dismal, trite (banala)
tronar 	thunder (tondri)
tronco 	stem, trunk, tree ? t r u n k (arbotrunko); stem, trunk (trunko)
trono 	throne (trono)
trozo 	slice (tran?a?o)
trucha 	trout (truto)
trueno 	thunder (tondro)
tu 	your (cia); your (via)
tubo receptor 	cathode tube (bildotubo); cathode tube (bildvalvo)
tuerca 	nut (boltingo); nut (?ra?bingo)
tumba 	grave, tomb (tombo)
tumor 	tumor, tumour (tumoro)
turca 	Turkishlady, Turkishwoman (turkino)
turco 	Turkish (turka); Turk (turko)
turista 	tourist (turisto)
turno 	file, line, rank, row, turn (vico)
tutear 	the e and thou (cidiri)
uf 	shame (fi)
ultrajar 	abuse, insult, offend (ofendi)
un 	one (unu); a, an (nedifinaartikolo)
una 	one (unu); a, an (nedifinaartikolo)
unas 	a few, any, some (kelkaj)
una vez 	once, one time (unufoje)
unirse 	associate, join, pool (unui?i)
universal 	general, usual (?enerala)
universidad 	university (universitato)
uno 	one (unu)
unos 	a few, any, some (kelkaj)
uno y medio 	one and a half (unukajduono)
un momento 	a few minutes, a moment (momenton)
urbano 	urban (urba)
urgente 	pressing, urgent (ur?a)
urgentemente 	urgently (ur?e)
urraca 	magpie (pigo)
usado 	worn (eluzita); used (uzita)
usar 	use up, wear out (eluzi); employ, use, make use of (uzi)
uso 	use (uzo)
usted 	ustedes 	ye, you (vi?)
uva 	grape (vinbero)
vaca 	cow (bovino)
vacaciones 	vacation (ferioj)
vaciar 	empty (malplenigi); bottle (spili)
vacilar 	hesitate (heziti); hesitate, waver (?anceli?i)
vainilla 	vanilla (vanilo)
vale 	agreed, okay (konsentite)
valer 	be worth (valori)
valle 	valley (valo)
valor 	courage (kura?o); value, worth (valoro)
valorar en 	blame, hold against (imputi)
valuta 	currency (valuto)
vampiro 	vampire (vampiro)
variar 	vary (varii)
variedad 	variety (vario)
varios 	several (diversaj)
vasco 	Basque (vaska); Basque, Basquelanguage (vaskalingvo); Basque (vasko)
vascuence 	Basque (vaska); Basque, Basquelanguage (vaskalingvo)
vaso 	glass (glaso); vase, vessel (vazo)
vecino 	adjacent (apuda); adjacent, adjoining (limtu?anta); adjacent, nearby, neighbouring (najbara); neighbour (najbaro)
vegetariano 	vegetarian (vegetarano)
veinte 	twenty (dudek)
veinte y uno 	twenty ? o n e (dudekunu)
vejiga 	bladder, bubble (veziko)
vela 	candle (kandelo)
velludo 	hairy, hirsute (harkovrita)
velocidad 	speed (rapido)
velocidad inicial 	initial velocity (komencrapido)
vena 	vein (vejno)
vencimiento 	end, terminate (fini?o)
vendaje 	bandage (banda?o); bandage (pansa?o)
vendar 	dress (pansi)
vendedor 	salesman (vendisto)
vendedora 	saleswoman (vendistino)
vender 	dispose of, sell, vend (vendi)
veneno 	poison (veneno)
venganza 	revenge, vengeance (ven?o)
vengar 	avenge, avenge oneself (ven?i)
venir 	come (veni)
venta 	sale (vendo)
ventaja 	advantage, benefit (avanta?o); advantage, benefit (utilo)
ventana 	window (fenestro)
ventilador 	electric fan, ventilator (ventolilo)
ventilar 	aerate, air out, give an airing, ventilate (aerumi)
ver 	see (vidi)
verano 	summer (somero)
verbena 	fair (kermeso)
verdad 	reality, truth (vero)
verdaderamente 	absolutely, gen u in ly, indeed, really, truly (vere)
verdadero 	true (vera)
verde 	green (verda); green (verdo)
verduras 	vegetable (legomo)
vergonzoso 	ashamed (hontigita); humiliating (humiliga)
vermut 	vermouth (vermuto)
verter 	pour in (enver?i)
vestido 	dress, gown, robe (robo)
vestir 	cover, overlay (tegi); clothe, dress (vesti)
vestirse 	dress, get dressed (vesti?i); dress (vestisin)
veterinario 	veterinarian (bestkuracisto); veterinarian (veterinaro)
viajar 	travel (voja?i)
viaje 	journey, trip, voyage (voja?o)
viajero 	traveller (voja?anto)
viaticar 	administer the last sacraments (sanktolei)
victoria 	victory (venko)
vida 	life (vivo)
vidrio 	glass (vitro)
viejo 	old (maljuna); old (malnova)
viento 	wind (vento)
vientre 	abdomen, belly, tummy (ventro)
viernes 	Friday (vendredo)
viga 	beam, girder (trabo)
vigilar 	guard, keep, look after, watch over (gardi)
vinagre 	vinegar (vinagro)
violento 	acute, intense, intensive (intensa)
violoncelo 	cello (violon?elo)
virtud 	energy (energio); force, strength, vigour (forto); courage (kura?o); ability (povo); morality, vice (virto); chastity, purity (?asteco)
visado 	visita 	visit (vizito)
visitar 	attend, call on, see, visit (viziti)
vista 	appearance, aspect, look, sight, view (aspekto); exterior (ekstera?o); view (elvido); view (panoramo); examination (rigardado); sight, view (vido)
vitamina 	vitamin (vitamino)
viudo 	widower (vidvo)
vivir 	be alive, live (vivi)
vivo 	alive (vivanta)
volante 	handlebars, helm, rudder (direktilo); joystick, steering ? w h e e l (stirilo)
volar 	fly (flugi)
voltaje 	tension, voltage (tensio)
voluntad 	will, willingness, wish (volo)
voluntariamente 	willingly (volonte)
volver 	turn away (forturni); go back, return (reiri); comeback, return (reveni); turn, turnaround, turn round (turni)
vomitar 	throw up, vomit (vomi)
vosotras 	you (vi?)
vosotros 	you (vi?)
votar 	vote (vo?doni)
voz 	vuelo 	flight (flugo)
y 	and (kaj)
ya 	already, by now, yet (jam)
yate 	yacht (ja?to)
ya ... no 	no longer (neplu)
ya que 	because, for the reason that (protioke); because, for the reason that (tialke); as, because, for, since (?ar)
yedra 	ivy (hedero)
yerba 	yerno 	son ? i n ? l a w (bofilo)
yerro 	aberration, error, mistake (eraro)
yo 	yodo 	iodine (jodo)
yogur 	yoghourt, yoghurt (jogurto)
yugo 	yoke (jugo)
y tambien 	and also, and . . . a s w e l l, as well as, together with (plie)
zalamero 	affectionate, caressing, cuddle some, cuddly (karesema)
zambullirse 	dive, plunge (plon?i)
zanahoria 	carrot (karoto)
zanja 	hole, ditch, pit (fosa?o)
zapatero 	shoemaker (?uisto)
zapatilla 	slipper (pantoflo)
zapato 	shoe (?uo)
zarza 	blackberry, blackberry bush, bramble (rubuso)
zarzamora 	blackberry (rubusbero)
zinc 	zinc (zinko)
zona 	zorro 	fox (vulpo)
zote 	addled, foolish, stupid (stulta)
zumo 	juice, sap (suko)
zumo de naranja 	orange juice (oran?osuko)
zurrar 	thrash (bategi)
