#Spanish-English FreeDict Dictionary
Adán	Adam(Adamo)
Alcorán	Koran(Korano)
Alejandro	Alexander(Aleksandro)
Alemania	Germany(Germanujo)
Alpes	Alps(Alpoj)
Amberes	Antwerp(Antverpeno)
Amsterdam	Amsterdam(Amsterdamo)
América	America(Ameriko¹)
América del Sur	South America(Sudameriko)
América meridional	South America(Sudameriko)
América septentrional	NorthAmerica(Nordameriko)
Andalucía	Andalusia(Andaluzujo)
Andorra	Andorra(Andoro)
Antillas	Antilles(Antiloj)
Anunciación	Annunciation, LadyDay(Anunciacio)
Apocalipsis	Apocalypse(Apokalipso)
Aquisgrán	Aix?la?Chapelle(Akeno)
Arabia	Arabia(Arabujo)
Argel	Algiers(Al?ero)
Argentina	Argentina(Argentino)
Arizona	Arizona(Arizono)
Aruba	Aruba(Arubo)
Ascensión	AscensionDay(?ielirtago)
Asia	Asia(Azio)
Asia Menor	AsiaMinor(MalgrandaAzio)
Asturias	Asturias(Asturujo)
Atenas	Athens(Ateno²)
Australia	Australia(A?stralio)
Austria	Austria(A?strujo)
Balkanes	Balkans(Balkanoj)
Barcelona	Barcelona(Barcelono¹); Barcelona(Barcelono²)
Bengala	Bengal(Bengalujo)
Berlín	Berlin(Berlino)
Biblia	Bible(Biblio)
Blanca?Nieve	LittleSnowWhite(Ne?ulino)
Bolivia	Bolivia(Bolivio)
Brasil	Brazil(Brazilo)
Bruselas	Brussels(Bruselo)
Bulgaria	Bulgaria(Bulgarujo)
Burdeos	Bordeaux(Burdegalo)
Báltico	Baltic Sea(BaltaMaro)
Bélgica	Belgium(Belgujo)
Canadá	Canada(Kanado)
Candelaria	Candlemas(Kandelfesto)
Castilla	Castile(Kastilujo)
Cataluña	Catalonia(Katalunujo)
Cenicienta	Cinderella(Cindrulino)
Cenopegias	FeastofTabernacles(Tendofesto)
Cerdeña	Sardinia(Sardinio); Sardinia(Sardio); Sardina(Sardlando); Sardinia(Sardujo)
Checoeslovaquia	Czechoslovakia(?e?oslovakujo)
Chile	Chile(?ilio)
China	China(?inujo)
Colombia	Colombia(Kolombio)
Colonia	Cologne(Kolonjo)
Colón	Columbus(Kolumbo)
Costa Brava	CostaBrava(Kostabravo)
Costa Rica	CostaRica(Kostariko)
Creta	Crete(Kreto)
Cristo	Christ(Kristo)
Cruz Roja	RedCross(Ru?aKruco)
Cuba	Cuba(Kubo)
Curazao	Curaçao(Kuraso)
Cáucaso	Caucasus(Ka?kazoj)
Córcega	Corsica(Korsiko)
Córdoba	Cordova(Kordovo¹)
Dinamarca	Denmark(Danujo)
Dios	God(Dio)
Ecuador	Ecuador(Ekvadoro)
Egipto	Egypt(Egiptujo)
El Salvador	ElSalvador(Elsalvadoro)
Escalda	Scheldt(Skeldo)
Escandinavia	Scandinavia(Skandinavio); Scandinavia(Skandinavujo)
Escocia	Scotland(Skotujo)
España	Spain(Hispanujo)
Estados Unidos	United States of America, USA(Usono)
Estonia	Estonia(Estonujo)
Estrasburgo	Strasbourg(Strasburgo)
Estrecho de Gibraltar	StraitofGibraltar(?ibraltaraMarkolo)
Etna	Etna(Etno)
Europa	Europa(E?ropo¹); Europe(E?ropo²); Europa(E?ropo³)
Europa occidental	WesternEurope(OkcidentaE?ropo)
Extremadura	Estremadura(Estremaduro)
Extremo Oriente	Far East, theFarEast(EkstremaOriento); FarEast(MalproksimaOriento)
Fiesta de los Tabernáculos	FeastofTabernacles(Tendofesto)
Finlandia	Finland(Finnujo)
Flandes	Flanders(Flandrujo)
Florencia	Florence(Florenco¹)
Francia	France(Francujo)
Frisia	Friesland(Frizonujo)
Gales	Wales(Kimrujo)
Galicia	Galicia(Galegujo)
Gante	Ghent(Gento)
Gibraltar	Gibraltar(?ibraltaro)
Ginebra	Geneva(?enevo)
Gran Bretaña	Britain, GreatBritain(Britujo)
Grecia	Greece(Grekujo)
Groenlandia	Greenland(Grenlando); Greenland(Groenlando)
Guatemala	Guatemala(Gvatemalo); GuatemalaCity(Gvatemalurbo)
Guinea Ecuatorial	EquatorialGuinea(EkvatoraGvineo)
Güeldres	Guelderland, Guelders(Geldrujo)
Génova	Genoa(?enovo)
Havana	Havana(Havano)
Holanda	Holland(Holando); Holland, theNetherlands(Nederlando)
Holanda septentrional	NorthHolland(Nordholando)
Honduras	Honduras(Honduraso)
Hungría	Hungary(Hungarujo)
IVA	VAT(aldonvaloraimposto)
India	India(Hindujo)
Indonesia	Indonesia(Indonezio)
Inglaterra	England(Anglio); England(Anglujo)
Irlanda	Ireland(Irlando)
Islandia	Iceland(Islando)
Islas Baleares	BalearicIslands(Balearoj)
Islas Canarias	CanaryIslands(KanariajInsuloj)
Islas Malvinas	Falkland Islands, Falklands(Falklandoj)
Italia	Italy(Italujo)
Japón	Japan(Japanujo)
Java	Java(Javo)
Jesucristo	JesusChrist(JesuoKristo)
Laponia	Lapland(Laponujo)
Latvia	Latvia(Latvujo)
La Haya	TheHague(Hago)
Letonia	Latvia(Latvujo)
Lieja	Liège(Lie?o)
Lisboa	Lisbon(Lisbono)
Lituania	Lithuania(Litovujo)
Livonia	Livonia(Livonujo)
Londres	London(Londono)
Lorena	Lorraine, Lothringen(Loreno)
Los Países Bajos	Holland, the Netherlands(Nederlando)
Lovaina	Louvain(Loveno)
Luxemburgo	Luxemburg(Luksemburgio); Luxemburg(Luksemburgo¹)
Madrid	Madrid(Madrido)
Mahoma	Mohammed, Muhammad(Mahometo)
Malinas	Malines, Mechlin(Me?lino)
Mallorca	Majorca(Majorko)
Marruecos	Morocco(Maroko)
Marsella	Marseilles(Marseljo)
Mar Cantábrico	BayofBiscay(GaskonaGolfo)
Mediterráneo	Mediterranean(Mezmaro)
Moisés	Moses(Moseo)
Mosa	Meuse(Mozo)
Moscú	Moscow(Moskvo¹)
Mosela	Moselle(Mozelo)
Munich	Munich(Mun?eno)
Méjico	Mexico(Meksikio)
México	Mexico(Meksikio); MexicoCity(Meksiko)
Navidad	Christmas, Yule(Kristnasko)
Nicaragua	Nicaragua(Nikaragvo)
Nilo	Nile(Nilo)
Nimega	Nimwegen(Nimego)
Norteamérica	NorthAmerica(Nordameriko)
Noruega	Norway(Norvegujo)
Noé	Noah(Noa?o)
Nuestra Señora	OurLady(NiaSinjorino); OurLady(laDipatrino)
Nueva Gales del Sur	NewSouthWales(NovaSudkimrujo)
Nueva York	New Amsterdam, New York, NewYorkCity(Novjorko)
Nápoles	Naples(Napolo)
Oceanía	Oceania, Oceanica(Oceanio)
Océano Pacífico	Pacific, PacificOcean(Pacifiko)
Pacífico	Pacific, PacificOcean(Pacifiko)
Panamá	Panama(Panamo)
Paraguay	Paraguay(Paragvajo)
París	Paris(Parizo)
Pascua	Easter(Pasko)
Patagonia	Patagonia(Patagonio)
País Vasco	BasqueCountry(Vaskujo)
Pentecostés	Pentecost, Whitsunday(Pentekosto)
Persia	Persia(Persujo)
Perú	Peru(Peruo)
Pirineos	Pyrenees(Pireneoj)
Polonia	Poland(Polujo)
Portugal	Portugal(Portugalujo)
Prusia	Prussia(Prusujo)
Purificación	Candlemas(Kandelfesto)
Redentor	Redeemer, Saviour(Ela?etinto); Redeemer, Saviour(Redemptoro); Saviour(Savinto)
Rin	Rhine(Rejno)
Rio Brava	RioGrande(Riobravo)
Rio Grande del Norte	RioGrande(Riobravo)
Roma	Rome(Romo)
Rumania	Romania(Rumanio); Romania(Rumanujo)
Rusia	Russia(Rusujo)
Sahara	Sahara(Saharo)
Sajonia	Saxe, Saxony(Saksio); Saxe, Saxony(Saksujo)
Salvador	Redeemer, Saviour(Ela?etinto); Redeemer, Saviour(Redemptoro); Saviour(Savinto)
Satanás	Lucifer, Satan(Satano)
Satán	Lucifer, Satan(Satano)
Sevilla	Seville(Seviljo)
Siberia	Siberia(Siberio)
Suecia	Sweden(Svedujo)
Suiza	Switzerland(Svisujo)
Surinam	Surinam(Surinamo)
Tajo	Tagus(Tago)
Todos los Santos	All Hallows, AllSaints'Day(SanktularaFesto); AllSouls'Day(TagodelaMortintoj)
Trinidad	Trinity(Triunuo)
Turquía	Turkey(Turkujo)
Támesis	Thames(Tamizo)
Túnez	Tunis(Tunizo)
Union Europea	EuropeanUnion(E?ropaUnio)
Unión soviética	Soviet Union, USSR(Sovetunio)
Uruguay	Uruguay(Urugvajo)
Valencia	Valencia(Valencio¹)
Venezuela	Venezuela(Venezuelo)
Viena	Vienna(Vieno)
Viernes Santo	GoodFriday(SanktaVendredo)
Vizcaya	Biscay(Biskajio); Biscay(Biskajujo)
Vístula	Vistula(Vistulo)
Yugoeslavia	Yugoslavia(Jugoslavujo)
Zelandia	Zealand(Zelando)
¿cuánto tiempo?	howlong?(kiellonge?); howlong?(kiomdatempo?)
¿cómo está usted?	how are you?, howdoyoudo?(kielvifartas?)
¿qué hora es?	whattimeisit?(kiomahoroestas?)
a	at, to, toward, towards(al); a, in, inside, into, on, per, within(en)
abad	abbot(abato); abbot(lamaestro); archimandrite(mona?estro)
abadesa	abbess(abatino)
abadía	abbey(abatejo)
abajo	below, downstairs, underneath(malsupre); below, underneath(sube)
abandonar	cede, give in, give up, give way, relinquish, yield(cedi); abandon, forsake, desert, leave, quit(forlasi)
abastacimiento	catering(proviantado); catering(provizumado)
abatido	dejected, depressed(korpremita)
abecé	alphabet(alfabeto)
abedul	birch(betulo)
abeja	bee(abelo)
abeto	fir(abio)
abierto	open(malfermita); open(nefermita)
abismo	abyss, chasm, gulf, precipice(abismo)
abjurar	abjure, forswear, swear off, renounce(forlasi?ure)
abolas	bearing(lagro)
abolición	abolition, abrogation(abolicio); abolition, abrogation(abolo); abolition(forigo)
abolir	abolish, abrogate(aboli); do away with, get rid of, remove(forigi)
abominable	abhorrent, abominable, alien, awful, hideous, horrible, gruesome(abomeninda)
abonado	subscriber(abonanto)
abonar	fertilize(sterki)
abonarse	subscribe, subscribeto(ekaboni)
abono	subscription(abono); dressing, fertilization, manuring(sterkado)
abordaje	collision(kolizio)
abordar	land(albordi?i); collide with, crashinto(koliziikun)
abrazar	embrace(brakumi); embrace, hug(?irka?braki)
abrelatas	can opener, tin?opener(skatolmalfermilo)
abreviación	abbreviation(mallongigo)
abreviar	abbreviate, abridge, shorten(mallongigi)
abreviatura	abbreviation(mallongigo)
abridor de tapones	bottleopener(botelmalfermilo)
abrigo	cloak, mantle(mantelo); coat, overcoat(palto); coat, overcoat(surtuto)
abril	April(aprilo)
abrir	open, openup(malfermi)
abrogar	abolish, abrogate(aboli); do away with, get rid of, remove(forigi)
absceso	abscess(absceso)
abstinencia	teetotalism, totalabstinence(abstemio)
abuela	grandmother(avino)
abuelo	grandfather(avo)
aburrido	boring, stodgy(enuiga); boring, stodgy, tiresome(teda)
aburrir	bore(tedi)
acabado	finishingoff(finaprilaborado); completed, done, finished, over, through(finita)
acabar	finish, workout(ellabori); accomodate, end, finish, terminate(fini); finish(finlabori); useup(forkonsumi); useup(foruzi); waste(mal?pari)
academia	academy(akademio)
acampar	camp, be encamped, lie encamped, campout(kampadi)
acaso	accidence, chance, hazard(hazardo)
accidente	accident(akcidento)
accionista	shareholder(akciulo)
acción	action, activity(agado); achievement, act, action(ago); share(akcio); accomplishment, achievement, act, action(faro)
acechar	set a trap, setatrapfor(insidi)
aceite	oil(oleo)
aceite de oliva	oil of olives, olive?oil(olivoleo)
aceituna	olive(olivo)
acelerador	accelerator, acceleratorpedal(akcelilo); accelerator, acceleratorpedal(gaspedalo)
acento	accent, stress(akcento); accent(prononcmaniero); accent mark, supersign(supersigno)
acentuar	accent, accentuate, stress(akcenti)
aceptable	acceptable(akceptebla); acceptable(akceptinda)
aceptación	acceptance, admission(akcepto)
aceptar	accept, receive, take, takein(akcepti)
acera	pavement, sidewalk(trotuaro)
acercarse	advance, come close, come closer, comeon(alproksimi?i)
acero	steel(?talo)
acertar	catch, hit, run across, strike(trafi)
achicoria	chicory(cikorio)
acidez de estómago	heartburn(pirozo)
acoger	greet, salute(saluti)
acogida	greeting, salutation(salutado)
acometer	commitaggression(agresi); assault, attack(ataki); assault, violate(atenci)
acometida	access, aggression, attack(atako)
acomodado	in easy circumstances, well?to?do(bonhava)
acomodar	accomodate(akomodi)
acompañamiento	accompaniment, escort(akompano)
acompañar	accompany(akompani)
aconsejar	advise, counsel(konsili)
acontecer	become, come about, grow, happen(fari?i); come about, happen, occur(okazi)
acontecimiento	chance, event, occurence, opportunity(okazo)
acordar	accede, agree, consent(konsenti)
acordarse	think(pensi)
acorde	accord, accordance, agreement, concurrence(akordo¹); concord(akordo³)
acordeón	accordion(akordiono)
acortar	abbreviate, abridge, shorten(mallongigi)
acostar	puttobed(enlitigi)
acostarse	gotobed(enliti?i)
acostumbrarse	accustom oneself, getused(kutimi?i)
activo	active(agema); active, inaction(aktiva); assets(aktivo); active, hardworking(laborema); transitive(transitiva)
actor	actor(aktoro)
actriz	actress(aktorino)
actual	current, present, present?day, topical, up?to?date(aktuala)
actualmente	at present, now(nun)
acuarela	water?colour(akvarelo)
acuario	aquarium(akvario)
acuerdo	accord, accordance, agreement, concurrence(akordo¹); accommodation, adjustment, arrangement(aran?o); accommodation, accord, agreement(interkonsento)
acumulador	accumulator, battery, storagebattery(akumulatoro)
acusación	accusal, accusation(akuzo); accusation(denunco); accusal, accusation, charge, complaint, indictment(kulpigo)
acusado	accused, defendant(akuzito); accused, defendant(kulpigito)
acusar	accuse(akuzi); accuse, denounce(denunci); accuse(plendikontra?)
adaptar	accomodate(akomodi); affiliate(filiigi)
adelantar	overhaul, overtake, pass(devanci); overhaul, overtake, pass(preterveturi)
adelante	ahead, foreward, on(anta?en)
adelgazar	fall away, lose, lose flesh, loseinweight(malplipezi?i)
además	besides, in addition, moreover(krome); besides, in addition, moreover(kromtio)
además de	apart from, besides, except, exceptfor(krom)
adiestrar	tame, train(dresi); break(obeigi)
adivinar	guess(diveni)
adiós	adieu, farewell, bye, goodbye(adia?)
adjetivo	adjective(adjektivo)
administración	administration, management(administrado); administration, management(administro)
administración del Sacramento	administrationofthelastsacraments(sanktoleado)
administrador	manager(administranto); administrator(administristo)
administrar	administer, manage(administri)
admirar	admire(admiri)
admisible	acceptable(akceptebla); acceptable(akceptinda)
admitir	accept, receive, take, takein(akcepti)
adoptivo	adopted(adoptita)
adoración	adoration, worship(adorado)
adorar	adore, worship(adori)
adornado	adorned(ornamita)
adquisición	accession, acquisition, gain(akira?o); accession, acquisition, asset(akiro)
aduana	customs(dogano)
adular	flatter(flati)
adverbio	adverb(adverbo)
advertidor de incendios	fire?alarm, firecall(brulavertilo)
adyacente	adjacent(apuda); adjacent, adjoining(limtu?anta); adjacent, nearby, neighbouring(najbara)
aeroplano	aeroplane, airplane, plane(aeroplano)
aeropuerto	aerodrome, airdrome, airfield(aerodromo); airport(aerohaveno); airport(flughaveno)
aeróstato	balloon, air?balloon(aerostato); balloon(balono)
afable	lovable(aminda)
afectación	affectation(afektado); affectation(afekto)
afectar	affect(afekcii)
afectuosidad	adherence, attachment(alligiteco); adherence, affection, attachment(sindoneco); attachement(sindonemo); attachment(sindono)
afectuoso	affectionate, devoted, selfless(sindona); devoted, selfless(sindonema)
afeitar	shave(razi)
aficionado	amateur, fancier(amatoro)
afligido	sad(afliktita); bleak, dismal, dreary, gaunt, miserable, sad, somber(malgaja); dismal, gaunt, miserable, sad(mal?oja)
afligir	afflict, grieve(aflikti); afflict, cause pain, cause pain to, distress, givepainto(mal?ojigi)
africana	Africanwoman(afrikanino)
africano	African(afrika); African(afrikano)
afán	attempt, effort(klopodo); efforts(penado); effort(peno); tension(stre?o)
agarrar	grasp(ekpreni); clutch, grapple(ekteni)
agencia	agency(agenteco)
agencia de viaje	tourist agency, travelagency(voja?agentejo)
agenda	agenda, appointmentbook(agendo)
agente	agent(agento)
agilidad	expertness, skilfulness, skill, skillfulness(lerteco)
agosto	August(a?gusto)
agotado	exhausted, tired out, wornout(lacega)
agradable	agreeable, enjoyable, lovely, nice, pleasant(agrabla); comfortable(komforta); pleasing(pla?a)
agradar	please(pla?i)
agradecer	thank(danki)
agrado	pleasure(pla?o)
agrario	agrarian, agricultural, farm?(agrara)
agresión	access, aggression, attack(atako); assault(atenco)
agresor	aggressor, assailant, attacker(atakanto)
agridulce	sweet?and?sour(dol?amara)
agrio	acetous, acid, sour, tart(acida); acid(acido)
agua	water(akvo)
aguardar	bide, abide, stay for, wait, await, waitfor(?isatendi)
aguas	spa(banurbo)
agua dolce	freshwater(sensalaakvo)
agua dulce	freshwater(dol?aakvo)
agua potable	drinking?water(trinkeblaakvo)
agudo	acute(akuta)
aguijón	sting(pikilo)
aguja	needle(kudrilo)
agujero	hole(truo)
agüero	indication, omen, portent, precursor, presage, sign(anta?signo); indication, omen, presage, portent, sign(a?guro)
ah	ah, aha(ha); oh(ho)
ahogarse	drown(droni)
ahora	at present, now(nun); currently, nowadays, thesedays(nuntempe)
ahora mismo	at once, immediately, just, right away, rightnow(tuj)
ahumado	smoked(fuma?ita)
aire	air(aero)
aire acondicionado	airconditioning(klimatizilo); airconditioning(klimatizo)
aislado	remote(izolita)
aislamiento	insulation, isolation(izolado); isolation, separation(izoliteco)
ajuar	furniture(meblaro)
ajustar	makeacontract(kontrakti); adjust(re?ustigi)
ají	chilli(kapsiko)
ala	wing(flugilo)
alabar	commend, laud, praise(la?di)
alambre	wire(drato); wire, ironwire(ferdrato)
alargar	give(doni); hand, handover(enmanigi); extend, strechout(etendi); pass, spend(pasigi); lengthen(plilongigi); convey, hand, hand over, pass(transdoni)
alarma	alarm(alarmo)
albaricoque	apricot(abrikoto)
albaricoquero	apricot?tree(abrikotarbo); apricot?tree(abrikotujo)
albergue	hostel, inn(gastejo)
albergue juvenil	youthhostel(junulargastejo)
alcachofa	artichoke(arti?oko)
alcade	mayor(urbestro); burgomaster, mayor, provost(vila?estro)
alcanzable	accessible(atingebla)
alcanzar	achieve, acquire, attain, get, obtain(akiri); accomplish, achieve, attain, get, reach(atingi)
alcohol	alcohol, booze, liquor, spirits, strongdrink(alkohola?o); alcohol(alkoholo)
alcohol de quemar	methylatedspirit(brulalkoholo)
alcázar	fortification(fortika?o)
aldea	village(vila?o)
alegre	happy, glad(?oja)
alegría	gladness, joy(?ojo)
alemana	German, Germanwoman(germanino)
alemán	German(germana); German, Germanlanguage(germanalingvo); German(germano)
alentar	encourage(kura?igi)
aleta	fin(na?ilo)
alfabeto	alphabet(alfabeto)
alfiler	pin, needle(pinglo)
alfombra	carpet(tapi?o)
algo	anything, something(io)
algodón	cotton(katuno); cotton(kotono)
alguien	a, any, anybody, some, somebody, one, some one, someone(iu)
alguno	a, any, anybody, some, somebody, one, some one, someone(iu)
alhaja	adornment, decoration, ornament(ornama?o); adornment, ornament(ornamo)
aliento	breath(spiro)
alimentar	feed, nourish(nutri)
alimento	food, nourishment(nutra?o)
alistar	recruit(rekrutigi); recruit(varbi)
alma	soul(animo)
almacén	warehouse(vardomo)
almanaque	almanac(almanako)
almeja	mussel(mitulo)
almendra	almond(migdalo)
almirante	admiral(admiralo)
almohada	pillow(kapkuseno); cushion(kuseno)
almorranas	haemorhoids(hemoroidoj)
almorzar	lunch(meztagman?i)
almuerzo	lunch, snack(lun?o)
almíbar	syrup(siropo)
alojamiento	accommodation(tranoktejo)
alojarse	be a guest of, staywith(gasti); be on a visit, stay, stop(gastlo?i)
alondra	lark(ala?do)
alquilado	hiredout(luigita)
alquilar	let(ludoni); hire(lui); let, rentout(luigi)
alquitrán	tar(gudro)
alrededores	environment, environs, surroundings(?irka?a?o)
alrededor de	about, round, around, towards(?irka?)
altar	altar(altaro)
alternar	alternate(alterni)
alternativa	alternation(alternado)
altitud	altitude, height(alto)
alto	contralto, contraltovoice(aldo); high, lofty, tall(alta); loud(la?ta)
altura	height(alteco)
altura barométrica	barometer reading, heightofthebarometer(barometraalto)
alumbrado	lighting(lumigo)
alumbrar	illuminate, light(lumigi)
alumbre	alum(aluno)
aluminio	aluminium, aluminum(aluminio)
al amanecer	atdaybreak(tagi?e)
al contrario	reverse, reversed(inversa)
al dorso	attheback(dorse); behind(malanta?e)
al día	aday(entago)
al fin	at last, finally, ultimately(fine)
al la derecha	ontheright(dekstre)
al menos	atleast(almena?)
al mismo tiempo	atthesametime(samtempe)
al norte de	above(nordede)
al presente	currently, nowadays, thesedays(nuntempe)
al principio	first, firstly, firstofall(unue)
al revés	reverse, reversed(inversa); vice?versa(inverse)
amable	affable, friendly, good?natured, kind(afabla); dainty, kind, nice, pretty(amabla); lovable(aminda)
amainar	abate, weaken(malforti?i); abate, decrease, diminish, drop, fall(malplii?i)
amanecer	dawn, daybreak(tagi?o)
amar	love(ami)
amargo	acerbic, bitter(amara)
amarillo	yellow(flava); yellow(flavo)
amarradero	landing?stage, pier(albordi?ejo)
amasadura	massage(masa?o)
amazona	Amazon(amazono)
ambos	both(amba?)
amenaza	menace, threat(minaco)
amenazar	menace, threaten(minaci)
americana	jacket(jako); Americanwoman(usonanino)
americano	American(amerika); American(amerikano); American(usona); American, UScitizen(usonano)
amerindio	Indian, AmericanIndian(indiano)
amianto	asbestos(asbesto)
amiga	friend(amikino)
amigo	friend(amiko)
amistad	friendship(amikeco)
amnistía	act of grace, amnesty(amnestio)
amo	boss, chief, leader(estro); chief, boss(?efo)
amojonar	mark out, trace, traceout(limdifini)
amoníaco	ammonia(amoniako)
amor	affection, love(amo)
amortiguador	shock?absorber(skusorbilo)
amortización	redemption(amortizo)
amortizar	amortize, deaden(amortizi); pay off, redeem(elpagi)
ampliación	aggrandizement, enlargement, increase(pligrandigo); enlargement, increase(pligrandi?o)
ampolla	bulb(ampolo); blister(blazo); blister(ha?tveziketo)
amputar	amputate(amputi)
amén	amen(amen)
amén de	apart from, besides, except, exceptfor(krom)
anales	annals(analoj)
analfabeto	illiterate(analfabeto)
ananás	pineapple(ananaso)
anatema	anathema, ban, excommunication(anatemo); anathema, ban, excommunication(ekskomuniko)
ancas de rana	frog'slegs(ranfemuroj)
anchas	comfort(komforto)
ancho	broad(lar?a)
anchoa	anchovy(an?ovo)
anchura	width(lar?eco); width(lar?o)
anciano	old(maljuna)
ancla	anchor(ankro)
anclar	anchor(ankrumi)
andar	march, walk(mar?i)
andas	litter, strecher(portilo)
andén	platform, quay, wharf(kajo)
anexar	annex(aneksi)
anexionar	annex(aneksi)
anexión	annexation(aneksado)
anguila	eel(angilo)
angustia	agony, anguish, fear(angoro); fright(timego)
angustioso	afraid, fearful(timigita)
anillo	ring(ringo)
animación	encouragement(kura?igo)
animal	animal(animalo); animal, beast(besto)
animar	encourage, impel, instigate, spur on, stimulate, urge(instigi); encourage(kura?igi); cheer, fire, inspire, stimulate(plifervorigi); fan, fire, inspire, stimulate, stir up, urgeon(plivigligi); rouse, stimulate, stirup(stimuli)
ano	anus, arse(anuso)
anoche	lastnight(hiera?vespere)
anonchecer	dusk(duonlumo)
anormal	abnormal(abnorma); abnormal(anormala); abnormal(nenorma); abnormal(nenormala)
anotación	annotation, note(komentario)
anotar	note, make a note, writedown(noti)
anteayer	thedaybeforeyesterday(anta?hiera?)
antebrazo	lower?arm(anta?brako)
antecedente	antecedent(anta?a?o); antecedent(antecedento)
antena	aerial, antenna(anteno)
anteriormente	ahead, formerly, previously(anta?e)
antes	before, infrontof(anta?); first, firstly, firstofall(unue)
antes de que	before, previousto(anta?ol)
anticongelante	antifreeze(kontra?frosta?o)
antideslizante	non?skid(kontra??ora)
antiguo	ancient, antique(antikva)
antigüedad	antiquity(antikvatempo)
antiséptico	antiseptic(antisepsa); antiseptic(antisepsilo); antiseptic(kontra?sepsa)
anualidad	instalment, repayment(anuitato)
anualmente	annual, yearly(?iujara)
anudar	tieon(kuniginode)
anular	cancel, countermand(malmendi); abjure, abolish, abrogate, annul, cancel, remit(nuligi)
anunciar	advertise, announce, givenotice(anonci); advise, counsel, notify(avizi)
anuncio	announcement, notification, notice(anoncado); ad, advertisement(anonco); notification, notice(avizo)
anzuelo	hook(fi?hoko)
anécdota	anecdote(anekdoto)
anís	anise(anizo)
anónimo	anonymous(anonima); anonymous, nameless, withoutaname(sennoma)
apagar	extinguish, putout(estingi)
aparador	chest, dresser(komodo)
aparador de cocina	dresser(kuirejstablo)
aparato	apparatus, device, set(aparato)
aparato para sordos	hearingaid(a?dilo); hearingaid(fonoforo)
aparcamiento	parkinggarage(parkadgara?o); car park, lay?by, parking bay, parking garage, parkingplace(parkejo)
aparcamiento de taxis	cab?stand(taksistacio)
aparecer	appear, emerge, perform(aperi)
apariencia	appearance(?ajno)
apartado	paragraph(alineo); remote(izolita)
apartamento	apartment, flat(apartamento)
apartar	divide, separate(apartigi); turnaway(forturni)
aparte	apart, particular, separate, special(aparta); apart, separately(aparte)
apelación	appeal(apelacio)
apellido	surname(familianomo)
apenas	barely, hardly, only just, scarcely(apena?)
aperitivo	dram, nip, peg, snifter, snorter(aperitivo)
apestar	reek, smell, smell bad, stink(fetori)
apetito	appetite(apetito)
apio	celery(celerio); turnip?rootedcelery(tubercelerio)
aplaudir	acclaim, applaud, clap(apla?di)
aplauso	acclaim, acclamation, approval(apla?do)
apoplejía	fit, apoplectic fit, seizure, stroke, strokeofapoplexy(apopleksio)
aporrear	thrash(bategi)
apostar	bet, wager(veti)
apostatar	apostatize(apostati?i)
apoyarse	lean(apogisin)
aprender	learn(lerni)
apresurarse	go fast, hurry, rush(rapidi); hurry, rush(ur?i?i); hurry(ur?isin)
apretar	press, oppress, squeeze(premi); fasten, tighten, turn, turnon(turniplipreme)
aprovechar	avail(utili); make use of, turn to good account, utilize(utiligi)
aprovecharse	profit(profiti)
aprovisionamiento	arrival, arrivals, supply(alportado); arrival, arrivals, supply(provizado)
aproximarse	advance, come close, come closer, comeon(alproksimi?i)
apróximadamente	about, approximately(proksimume)
apuntar	note, make a note, writedown(noti)
apéndice	accessory, side?issue(akcesora?o); addition, adjunct(aldono); appendix(apendico)
apócrifo	apocryphal(apokrifa)
apóstata	apostate(apostata)
apóstol	apostle(apostolo)
arabesco	arabesque(arabesko)
arado	plough(plugilo)
araña	spider(araneo)
arbusto	bush, shrub(arbusto)
arca	ark(arkeo); box, chest(kesto)
archi?	arch?, chief?(?ef?)
archiduque	archduke(?efduko)
archipiélago	archipelago(arkipelago); archipelago(ar?ipelago); archipelago(insularo)
archivero	archivist, keeperoftherecords(ar?ivisto)
archivista	archivist, keeperoftherecords(ar?ivisto)
archivo	archive, archives, files, records(ar?ivo)
arcilla	clay(argilo)
arco iris	rainbow(?ielarko)
arder	burn(bruli)
ardilla	squirrel(sciuro)
arena	arena(areno); sand(sablo)
arenas movedizas	quicksand, quicksands(dronmar?ejo); quicksand, quicksands(movsablo)
arenque	herring(haringo)
arenque ahumado	redherring(fuma?itaharingo)
argelina	Algerianwoman(al?erianino)
argelino	Algerian(al?eria); Algerian(al?eriano)
argentina	Argentinianwoman(argentinanino)
argentino	Argentine, Argentinean(argentina); Argentine(argentinano)
argumento	argument, plea(argumento)
aristócrata	aristocrat(aristokrato)
arma	weapon(armilo)
armar	arm(armi)
armario	cabinet, closet, cupboard, sideboard(?ranko)
armario para libros	bookcase(libro?ranko)
armario ropero	clothes?press, wardrobe(vesto?ranko)
arquitecto	architect(ar?itekto)
arrancar	pick, pluck, tearoff(de?iri); put on, start, switch on, turnon(ekfunkciigi); startrunning(ekkuri); extort, wrest, wring(eldevigi); abstract, takeaway(forpreni); start(startigi)
arranque	run(ekkuro)
arreglar	arrange, put in order, tidy(ordigi)
arreglo	accommodation, adjustment, arrangement(aran?o); accommodation, accord, agreement(interkonsento)
arrendar	hire(lui)
arrepentimiento	repentance(pento)
arrestar	arrest(aresti)
arresto	apprehension, arrest, detention(arestado); apprehension, arrest, detention(aresto)
arriba	above, on top, overhead, upstairs(supre)
arriesgado	adventurous, hazardous, risky(riska)
arriesgar	hazard, risk, venture(riski)
arroba	atpersand, commercial?at sign, snail(volvitaA)
arrodillarse	kneel(genui); kneel(genui?i); kneel(surgenui); kneel(surgenui?i)
arrogante	arrogant(aroga); arrogant(aroganta); arrogant(malmodesta); arrogant(pretendema)
arrojar	result(rezulti)
arromar	blunt(malakrigi)
arroyo	stream(rivereto)
arroz	rice(rizo)
arruinar	ruin(ruinigi)
arrurruz	curry(kareo)
arte	art(arto)
arteria	artery(arterio)
artesanía	handiwork(manfarita?o)
artificial	artificial(artefarita)
artillero	artilleryman, gunner(artileriano); artilleryman, gunner(artileriisto)
artillería	artillery(artilerio)
artista	artist(artisto)
artículo	article, commodity(artiklo); article(artikolo¹); article(artikolo²)
artículos de cuero	leathergoods(leda?oj)
artículo determinado	definitearticle(difinaartikolo)
artístico	artistic(artista)
arzo?	arch?, chief?(?ef?)
arzobispado	archbishopric(?efepiskoplando)
arzobispo	archbishop(metropolito); archbishop(?efepiskopo)
as	ace(aso)
asado	roasted(rostita)
asalter	assault, violate(atenci)
asar	roast, toast(rosti)
ascender	ascend, climb, scale(surgrimpi)
ascender a	amountto(sumi?ije)
ascensor	elevator, lift(lifto)
asediar	besiege(sie?i)
asedio	siege(sie?o)
asegurador	insurer(asekuristo)
asegurar	insure(asekuri); affirm, assure(certigi)
asentir	affirm, assent, sayyes(jesi)
asfalto	asphalt(asfalto)
asiento	seat(sidejo)
asilo	asylum(azilo)
asir	clutch, grab, grasp, grip, seize(ekkapti); clutch, grapple(ekteni); capture, catch, grapple(kapti)
asistencias	alimony(alimento)
asistente	aid, assistant, helper(asistanto)
asiático	Asian, Asiatic(azia); Asian(aziano)
asma	asthma, shortness of breath, wheeziness(astmo)
asombrar	amaze(mirigi)
asombrarse	marvel, marvel at, wonder(miri)
aspecto	appearance, aspect, look, sight, view(aspekto); exterior(ekstera?o)
aspirina	aspirin(aspirino)
aster	aster(astero)
astilla	splinter(lignero); splinter(splito)
astrigente antidiárrico	adstringent(adstringilo); adstringent(konstipilo); adstringent(mallaksigilo)
astronauta	astronaut, spaceman(astrona?to)
astucia	snare(insido); craft, craftiness, cunning, guile(malico)
astuto	insidious(insida); malicious, mischievous, nasty, vicious(malica)
asumir	guess, presume, suppose, surmise(supozi)
asunto	affair, business, business deal, case, matter(afero)
así	so, such, thus(tiel)
así así	soso(bonete)
así como	and also, and ... as well, as well as, togetherwith(kajanka?); and also, and ... as well, as well as, togetherwith(plie)
atacador	aggressor, assailant, attacker(atakanto)
atacar	commitaggression(agresi); assault, attack(ataki)
ataque	access, aggression, attack(atako); assault(atenco)
atención	acuity, advertence, advertency, attention(atento)
atender	advert, pay attention, pay attention to, watchoutfor(atenti)
atender a	advert, pay attention, pay attention to, watchoutfor(atenti); lookafter(prizorgi)
atentado	assault(atenco)
atento	attentive(atenta); attentive(atentema)
aterrizaje	landing(surteri?o)
aterrizar	land(surteri?i)
atleta	athlete(atleto)
atletismo	athletics(atletiko)
atlántico	Atlantic(atlantika)
atlético	athletic(atleta)
atmosférico	atmospheric(atmosfera)
atmósfera	atmosphere(atmosfero)
atomización	fission(atomfendado)
atornillar	screw(?ra?bi)
atracar	land(albordi?i)
atractivo	attractive(alloga)
atraer	attract, draw(allogi); attract(altiri)
atrasado	backward, mentally deficient, retarded(mensepostrestanta)
atrasarse	belate(malfrui)
atrasos	arrears(postrestapozicio)
atravesar	cross, go beyond, transfer(transiri); gobeyond(transpasi)
atrayente	attractive(alloga)
atreverse	be bold, dare(kura?i)
atropallamiento	collision(kolizio)
atropellar	collide, run(alveturi)
atrás	at the back, behind, intherear(jelafino); behind(malanta?e); backward, backwards(malanta?en); backwards(posten); back, backwards(reen)
aturdir	drug(narkoti); drug, intoxicate, stun, stupefy(svenigi)
atún	tuna, tuna?fish, tunny(tinuso)
audiencia	audience(a?dienco)
aula magna	auditorium(a?lo)
aumentar	accrue, grow(kreski); increase, freshen(pliforti?i); accrue, increase(pligrandi?i)
aumento	accretion, growth(kresko)
aunque	though, although(kvankam)
ausencia	absence(foresto)
ausente	absent(foresta); absent(forestanta); absent(mankanta)
australiano	Australian(a?straliano)
austriaco	Austrian(a?stra); Austrian(a?stro)
autobús	bus, autobus, omnibus(a?tobuso)
autoestrada	motor road, motorway(a?tostrado); motor road, motorway(a?to?oseo)
automático	automatic(a?tomata); automoton(a?tomato)
automóvil	car(a?to)
autopista	motor road, motorway(a?tostrado); motor road, motorway(a?to?oseo)
autor	author(a?toro); author, writer(verkisto)
autoridad	authority(a?toritato)
autorización	authorization(rajtigo)
autovía	motorway, super highway, turnpike(a?to?oseego)
autócrata	absolute ruler, autocrat(a?tokrato)
autónomo	autonomic, autonomous(a?tonoma)
avalancha	avalanche(lavango)
ave	bird(birdo)
avellana	hazelnut(avelo)
avena	oats(aveno)
avenida	avenue(aleo)
aventajar	exceed, surpass(superi)
aventura	adventure(aventuro)
aventurero	adventurous(aventura); adventurous(aventurema); adventurer(aventuristo)
avergonzarse	beashamed(honti)
averia	brakedown(paneo)
aversión	abhorrence, abomination, horror(abomeno); aversion, dislike(antipatio); disgust, nausea(na?zo)
avería	damage(averio)
aves	birds(birdaro); fowl, poultry(birda?o)
avestruz	ostrich(struto)
aviación	aeronautics, aviation(aviado)
avisar	caution, warn(averti)
aviso	warning(averto); notification, notice(avizo)
avispa	wasp(vespo)
avión	aeroplane, airplane, plane(aeroplano); aircraft(aviadilo)
axioma	axiom(aksiomo)
ay	ah, oh, ow(a?); woe(ve)
ayer	yesterday(hiera?)
ayuda	aid, help(asisto); aid, help(helpo)
ayudante	adjutant, aide?de?camp(adjutanto); aid, assistant, helper(asistanto)
ayudar	accomodate, aid, assist, help(helpi)
ayunar	fast(fasti)
ayuntamiento	town?hall(magistratadomo); city hall, townhall(urbdomo)
azada	hoe(sarkilo)
azafata	stewardess(stevardino)
azteca	Aztec(asteka)
azucarero	sugar?bowl, sugarbowl(sukerujo)
azul	blue(blua); skyblue(lazuro)
azulejo	tile(kahelo)
azúcar	sugar(sukero)
aún	still, yet(ankora?)
a bordo	aboard(en?ipi?inta)
a cuadros	checked, chequered(kvadratita)
a eso de	about, approximately(proksimume)
a instancias de	attheinstanceof(la?insistode)
a la cubana	intheCubanway(kube)
a la izquierda	ontheleft(maldekstre)
a lo largo de	along(la?longede); through(tra)
a lo menos	atleast(almena?); atleast(minimume)
a menudo	frequently, often, regularly(ofte)
a propósito	bytheway(parenteze)
a que	until, till(?is)
a saber	thatis(tioestas)
a su salud	cheers, goodhealth(jeviasano)
a tiempo	at the right time, intime(?ustatempe)
a través de	across, beyond, ontheothersideof(trans)
a veces	several times, sometimes(kelkfoje)
año	year(jaro)
año bisiesto	leap?year(superjaro)
año nuevo	NewYear'sDay(novjaratago)
babero	bib(salivtuketo)
babor	portside(babordo)
babosa	slug(limako)
bacalao	cod, codfish(moruo)
bache	pole(foso); cavity(kava?o); cave, cavity(kavo)
bacteria	bacterium(bakterio)
badajo	clapper(sonormartelo)
bagatela	trifle(bagatelo)
bagazo	bagasse(bagaso)
bahía	bay(golfeto)
bailar	dance(danci)
bailarín de ballet	balletdancer(baletisto)
baile	ball, dance(balo); dance(danco)
baja	abatement(malplii?o); decay(ruini?o)
bajamar	lowtide(refluo)
bajar	getout(elvagoni?i); descend, godown(mallevi?i); decrease, lower(malplialtigi); descend, get off, godown(malsupreniri); discount, rebate(rabati)
bajo	bass, bassvoice(baso); low(malalta)
bajorrelieve	bas?relief, lowrelief(bareliefo)
bala	bale(pakego)
balance	balancesheet(bilanco)
balancear	rock, swing(balanci); balance, poise(balanci?i)
balanza	scales(pesilo)
balaustrada	balustrade, banisters, parapet, railing(balustrado)
balcón	balcony(balkono)
baliza	buoy(buo); beacon(gvidmarkilo)
ballena	baleen, whalebone(balenlameno); whale(baleno); baleen, whalebone(balenosto); busk, steel(barto)
ballet	ballet(baledo)
balneario	spa(banurbo)
baloncesto	basketball(basketbalo)
balotaje	ballot, balloting, votingbyballot(balotado)
bambú	bamboo(bambuo)
bancarrota quiebra	bankruptcy, failure(bankroto)
banco	bank(banko); bench(benko)
bandeja	tray(pleto)
bandera	banner, flag(flago); flag, standard(standardo)
bandido	bandit(bandito)
banquero	banker, bankmanager(bankestro)
banquete	banquet(bankedo); banquet, feast(festeno)
bar	buffet(bufedo); bar, pub(trinkejo)
barato	cheap, inexpensive(malkara)
barba	beard(barbo); chin(mentono)
barbero	barber(barbiro); barber(barbisto); barber(razisto)
barco	bark, barque(barko); boat(boato); ship, vessel(?ipo)
barco de remos	row?boat, rowing?boat(remboato)
barco de vapor	steamship(vapor?ipo)
barman	barman, bartender(trinkejaservisto)
baronesa	baroness(baronino)
barraca	barrack, barn, shack, shanty, shed(barako)
barra de chocolate	barofchocolate(?okoladbriketo)
barrena	bore(borilo)
barrendero	sweeper(glacibalaisto)
barrer	sweep(balai)
barricada	barricade(barikado)
barrio	district, neighbourhood, quarter(kvartalo)
barrio bajo	back street, slum(kvartala?o)
barro	mud(koto)
barítono	baritone(baritono)
barómetro	barometer(barometro)
barón	baron(barono)
basalto	basalt, whimstone(bazalto)
basar	base(bazi)
bastante	a little, rather, some, somewhat, tosomeextent(iom); rather(meze); enough, sufficient(sufi?a); enough, quite, rather, sufficiently(sufi?e)
bastar	suffice(sufi?i)
bastardo	bastard(bastardo)
bastidor	flat(kuliso)
basurero	dump, refuse dump, tip, rubbishtip(defala?ejo); dump, refuse dump, tip, rubbishtip(resta?ejo)
bata	négligé, undress(negli?o)
batalla	action, battle, scuffle, struggle(batalo)
batallón	battalion(bataliono)
batata	sweet potato, yam(batato)
batería	battery(baterio); battery(pilaro)
batista	batiste, cambric, lawn(batisto)
baya	berry(bero)
bayeta	baize(krudlan?tofo)
bazar	bazaar, fair, market(bazaro); bazaar(?iovendejo)
baúl	trunk(kofro)
bañador	swimmingtrunks(bankalsono)
bañar	bathe(bani)
bañarse	bathe, haveabath(banisin)
bañero	bath superintendant, bathssuperintendant(banejgardisto)
baño	bath(bankuvo); bath(bano)
beber	drink(trinki)
bebida	beverage, drink(trinka?o)
bebé	baby(bebo)
beige	beige(flavgriza)
belga	Belgian(belga); Belgian, Belgianwoman(belgino); Belgian(belgo)
belleza	beauty(beleco)
bencina	gasolene, gasoline, petrol(benzino)
besar	kiss(kisi)
beso	kiss(kiso)
bestia	animal, beast(besto)
bestial	beastly, bestial(besteca)
biblioteca	library(biblioteko)
bicarbonato	bicarbonateofsoda(natriabikarbonato)
bicicleta	bike, cycle, bicycle(biciklo); bike, bicycle(ciklo²)
bien	okay, well(bone)
bienvenida	welcome(bonvenon)
bife	steak, beefsteak(bifsteko)
biftec	steak, beefsteak(bifsteko)
bigoti	moustache(liphararo)
bilis	bile, gall(galo)
billete	bill, ticket, note(bileto)
billete del tren	railway ticket, trainticket(trajnbileto)
billete de banco	bank?note(monbileto)
billete de entrada	admissionticket(enirbileto)
billete de equipaje	luggageticket(paka?bileto)
billete de ida y vuelta	return?ticket(irorevenabileto)
billete de viaje	ticket(veturbileto)
billete por un día	day?ticket(tagbileto)
biquini	bikini(bikino)
birrete	beret(bireto); cap(?apo)
bisnieta	greatgranddaughter(pranepino)
bisnieto	greatgrandson(pranepo)
bistec	steak, beefsteak(bifsteko)
bisté	steak, beefsteak(bifsteko)
bizcocho	bicuit(biskoto); biscuit, cookie(biskvito)
blanco	white(blanka¹)
bloc de notas	notepad(leterbloko); notepad(notbloko); notepad(notfoliaro)
bloque	block, pad(bloko)
blusa	blouse(bluzo)
boca	mouth(bu?o¹)
bocadillo	roll(bulko); sandwich(sandvi?o)
boca arriba	backward, onone'sback(dorsen); backwards(posten)
bocina	hooter(hupo); hooter, horn, klaxon(korno²)
boda	wedding, wedding?party(edzi?afesto); wedding, wedding?party(geedzi?afesto)
boina	beret(vaska?apo)
bola	chunk, clod, lump(bulo); bullet(kuglo)
bolsa	hand?bag(mansako)
bolsa de trabajo	employment exchange, labor exchange, labourexchange(dungperejo)
bolsa para bicicletas	cycle?bag(biciklosako)
bolsa para señoras	lady's bag, vanitybag(virinsaketo)
bolígrafo	ballpointpen(globkrajono)
bomba	bomb(bombo); pump(pumpilo)
bomba atómica	atombomb(atombombo)
bomba incendiaria	incendiarybomb(brulbombo)
bombón	bonbon, bon?bon(bombono)
bondad	goodness(boneco)
boniato	sweet potato, yam(batato)
bonito	affable, friendly, good?natured, kind(afabla); beautiful, fine, handsome, lovely(bela); nice(boneta); delightful, lovely(rava); charming, lovely(?arma)
borde	border, brim, brink, edge, edging, fringe, rim(rando¹)
borracho	drunk, intoxicated(ebria)
bosque	forest, woods(arbaro)
bota	boot(boto)
bota de montaña	mountaineeringboot(mont?uo)
botella	bottle(botelo)
botella de gas	gas cannister, gascylinder(gasbotelo)
botica	chemist's shop, drugstore(apoteko)
boticario	chemist(apotekisto)
botón	button(butono¹); button(butono²)
botón de presión	push?button(prembutono)
boxeador	boxer(boksisto)
boya	buoy(buo)
braguitas	briefs(kalsoneto)
branquia	gill(branko)
brasileña	Brazilianwoman(brazilanino)
brasileño	Brazilian(brazila); Brazilian(brazilano)
bravo	brave, courageous, valiant(kura?a)
brazalete	bracelet(braceleto); bracelet(?irka?brako)
brazo	arm(brako¹)
brema	bream(bramo¹)
brezal	heath(erikejo)
brillar	shine(brili)
britano	Briton(brito)
británico	British(brita)
brocha de afeitar	shaving?brush(razpeniko)
broma	gag, joke(?erco)
bromear	jest, joke(?erci)
bronco	abrupt(bruska); brutal, gruff, harsh, rough, sour, surly, unkind, unpleasant(malafabla)
brumoso	fuzzy, misty(nebula)
brusco	abrupt(bruska)
brusko	brutal, gruff, harsh, rough, sour, surly, unkind, unpleasant(malafabla)
brújula	compass(kompaso)
bucear	dive, plunge(plon?i); dive, sink(subakvi?i)
buenas noches	goodnight(bonannokton)
buenas tardes	goodevening(bonanvesperon)
bueno	good, nice, okay(bona)
buenos días	goodmorning(bonanmatenon); goodday(bonantagon)
buey	ox(okso)
buho	owl(strigo)
bujía	plug, sparkplug(sparkilo)
bula	indulgence(indulgenco)
burdel	brothel(bordelo)
burla	gag, joke(?erco)
burro	ass, donkey(azeno)
buscar	fetch, get, pickup(irpreni); get, lay hold of, pick up, take(preni); look for, seek(ser?i)
butaca	armchair(brakse?o)
butifarra de hígado	liversausage(hepatkolbaso)
buzón	letterbox, mailbox(leterkesto)
bálsamo	balm, balsam(balzamo)
báltico	Baltic(balta)
bárbaro	barbarian(barbaro)
bázico	basic(baza)
búfalo	buffalo(bubalo)
búlgara	Bulgarianwoman(bulgarino)
búlgaro	Bulgarian(bulgara); Bulgar, Bulgarian(bulgaro)
cabal	absolute, complete(kompleta); entire, overall, whole(tuta)
caballero	cavalier, knight(kavaliro¹)
caballería	cavalry(kavalerio)
caballo	horse(?evalo)
caballos	horsepower(?evalforto); horsepower(?evalpovo)
caballo padre	stallion(vir?evalo)
cabana	cabin, hut, shack(kabano)
cabeza	head, pate(kapo¹)
cabina	bathingbox(banbudo); bathingbox(bankajuto); barn, shed, stand(budo)
cabina telefónica	call box, telephone kiosk, phone booth, telephonebooth(telefonbudo)
cable	cable(kablo)
cable de remolque	towing?line(trenkablo)
cabra	goat(kapro)
cabrón	he?goat(virkapro)
cacahuete	peanut(arakido)
cacahué	peanut(arakido)
cacao	cocoa(kakao)
cacerola	casserole, saucepan(kaserolo)
cacto	cactus(kakto)
cada vez	each time, everytime(?iufoje)
cadena	chain(?eno)
cadena antideslizante	non?skidchain(kontra?glita?eno)
cadera	hip(kokso)
caer	drop, fall(fali)
caer enfermo	be taken ill, fallill(malsani?i)
cafetera	coffee?pot(kafkru?o); coffee?pot(kafujo)
cafetería	cafetaria(kafeterio)
café	café, coffee?house(kafejo)
caja	cashier's stand, fund, money box, money?box, till(kaso); box, chest(kesto); box(skatolo); jug, box, container, vessel(ujo)
caja de cambios	gear?box, gear?case(rapidumskatolo); gear?box, gear?case(rapidumujo)
cal	lime(kalko)
calabacín	courgette, zucchini(kalabaseto)
calabaza	calabash, gourd(kalabaso)
calamar	sepia(sepio)
calcetín	sock(?trumpeto)
calcular	calculate, count, figure, workout(kalkuli)
caldo	bouillon(buljono)
calefacción	heating(hejtado)
calefacción central	centralheating(centrahejtado)
calendario	almanac(almanako)
calentar	heat, stoke(hejti)
calidad	property, quality(kvalito)
caliente	warm(varma); hot(varmega)
callarse	bequiet(silenti)
calle	street(strato)
calleja	alley, lane(strateto)
callo	corn(kalo)
calmar	appease, calm, quiet, soothe, still(trankviligi)
calmarse	abate, subside(kvieti?i); calmdown(trankvili?i)
calor	heat(varmego)
caloría	calorie(kalorio)
calumniar	slander(kalumnii)
calzador	shoe?horn, shoe?lift(?ukorno)
calzoncillos	drawers, panties, underpants(kalsono)
cama	sleeping?accomodation, sleeping?place(dormejo); bed(lito)
camarera	dressing?gown(hejmvesto); waitress(kelnerino); dressing?gown(negli?arobo)
camarero	waiter(kelnero)
camarote	cabin(kajuto)
cama de matrimonio	doublebed(dupersonalito)
cambiar	alter, change(alii?i); interchange, swap(inter?an?i); vary(varii); change, turn(?an?i)
cambio	variety(vario); change(?an?mono)
camello	camel(kamelo)
camilla	litter, strecher(portilo)
camino	path, road, way(irejo); road, route, way(vojo)
camino sin salida	blind alley, cul?de?sac(sakvojo)
camisa	shirt(?emizo)
camisa de deporte	sportsshirt(sport?emizo)
camiseta	shirt(?emizo)
camisón	night?shirt(nokto?emizo)
camita	bedstead(litkadro)
camita de niño	child's bed, cot(infanlito)
camión	lorry, truck(kamiono); lorry, truck(?ar?a?to)
camote	sweet potato, yam(batato)
campamento	camping ground, campingsite(kampadejo); camp of tents, tentedcamp(tendaro)
campana	hood, suctionapparatus(desu?ilo)
campanilla	bell(sonorilo); bell(tintilo); blister(veziketo)
campesino	farmer(kampulo)
camping	camping ground, campingsite(kampadejo)
campo	field(agro); country, countryside(kamparo); field(kampo¹)
campo deportivo	sportsground(sportejo)
campo santo	cemetery, God's acre, graveyard(tombejo)
canal	canal, channel(kanalo)
canapé	couch, sofa(kanapo)
canario	Canary(kanaria)
canción	song(kanto)
candelero	candlestick(kandelingo)
cangrejo	crayfish(kankro); crab(krabo)
cansado	tired(laca)
cansar	fag out, jade, overdrive, override(lacegigi)
cantar	sing(kanti)
cantidad	quantity(kvanto); amount, sum(sumo)
cantor	singer(kantisto)
cantora	singer, femalesinger(kantistino)
cantábrico	Cantabrian(kantabra)
caos	chaos, tangle(?aoso)
capacidad	ability(kapableco); ability, capability, fitness, suitability(ta?geco)
capaz	able, capable(kapabla)
capital	capital(kapitalo); metropolis(metropolo); capital, capital city, metropolis(?efurbo)
capitanear	govern, head up, restrain(estri); command, be in command, order(komandi)
capitular	capitulate, surrender(kapitulaci)
capitán	boss, chief, leader(estro); chief, boss(?efo)
capot	bonnet, hood(kapoto)
cara	face(viza?o)
caracol	snail(heliko)
carburador	carburettor(karburilo)
carbón	charcoal(lignokarbo)
cardo	thisle(kardo)
carga	burden, charge, load(?ar?o)
cargar	burden, load(?ar?i)
cargo	accusal, accusation(akuzo); accusation(denunco); function(funkcio); accusal, accusation, charge, complaint, indictment(kulpigo); function, job, office, post(ofico)
carnada	bait(loga?o)
carnaval	carnival(karnavalo)
carne	flesh(karno); meat(viando)
carnero	ram, tup(vir?afo); mutton(?afa?o)
carnestolendas	carnival(karnavalo)
carnet	notebook(notlibro); attempt, test(provo)
carnet de conducir	driving?licence(kondukpermesilo)
carne de cerdo	pork(porka?o)
carne de cordero	lamb(?afida?o)
carne de ternera	veal(bovida?o)
carne de vaca	beef(bova?o)
carne picada	mincedmeat(viandhaketa?o)
carne salada	salt meat, saltedmeat(peklitaviando)
carnicero	butcher(bu?isto)
carnicería	butcher'sshop(bu?ejo); butcher'sshop(bu?istbutiko)
carné	attempt, test(provo)
caro	dear, expensive, valuable(kara²); dear, expensive(kosta); costly, dear, expensive, pricey(multekosta)
carrera	career(kariero)
carrete	film(filmruleto)
carretera	motor road, motorway(a?tostrado); motor road, motorway(a?to?oseo)
carretera principal	majorroad(prioritatavojo); majorroad(?efvojo)
carretera resbaladiza	dangerofskidding(jordan?ero)
carretera secundaria	by?way, side?way(flankvojo)
carrete de rueda	hub, nave(nabo)
carro	cart, chariot(?aro)
carrocería	body, coach?work(karoserio)
carroña	carrion(kadavra?o)
carta	letter(letero)
carta aérea	air letter, aerogramme(aerpo?taletero)
cartearse	correspond(korespondi)
cartel	notice, placard, poster(afi?o)
cartera	wallet(monbiletujo); briefcase, file(teko)
cartero	postman(leterportisto)
casa	house(domo¹)
casada	married(edzini?inta)
casado	married(edzi?inta)
casarse	marry, be married, getmarried(edzini?i); marry, be married, getmarried(edzi?i); marry, be married, getmarried(geedzi?i)
casa de huéspedes	boarding house, boardingschool(pensiono)
cascada	waterfall(akvofalo); waterfall(kaskado)
cascajo	broken stones, chippings, road?metal, rubble, stone?chippings(?tonetaro)
casi	almost, nearly(preska?)
caso	affair, case, matter(kazo¹)
caspa	dandruff(kapha?teroj)
castaña	chestnut, horse?chestnut(ka?tano)
castaño	chestnut?tree(ka?tanarbo); chestnut?tree(ka?tanujo)
castellano	Castillian(kastila)
castigar	punish(puni)
castigo	redemption(amortizo); punishment(puno)
castillo	castle(kastelo)
castor	beaver(kastoro)
catalán	Catalonian(kataluna)
catecismo	catechism(kate?ismo)
catedral	cathedral(katedralo)
catorce	fourteen(dekkvar)
catálogo	catalogue, directory(katalogo)
católico	Catholic(katolika); catholic(katoliko)
cauce	bed, watercourse(fluejo)
caucho	rubber(ka??uko)
caudillo	boss, chief, leader(estro); chief, boss(?efo)
causa	cause, reason(ka?zo)
causar	activate, cause, giveriseto(ka?zi)
cavar	dig, grub, spade(fosi)
cazar	chase, hunt(?asi)
caótico	chaotic(?aosa)
caña	fishingrod(fi?vergo)
caña de pescar	fishingrod(fi?vergo)
cebada	barley(hordeo)
cebo	bait(loga?o)
cebolla	onion(cepo)
cebollana	chive(?enoprazo)
ceder	cede, give in, give up, give way, relinquish, yield(cedi)
ceja	brow, eyebrow(brovo)
celebrar	celebrate(celebri)
celebrar su cumpleaños	celebratingone'sbirthday(festisiannaski?tagon)
celebrar una fiesta	celebrate(festi)
celo	fervor, fervour, zeal(fervoro)
cementerio	cemetery, God's acre, graveyard(tombejo)
cena	dinner, middaymeal(tagman?o); evening meal, supper(vesperman?o)
cenicero	ashtray(cindrujo)
ceniciento	ashen(cindrogriza)
ceniza	ash, cinder(cindro)
censura	censor(cenzuro); criticism(kritiko); observation, remark, reproof(malla?do); observation, remark(ripro?arimarko)
censurable	blameworthy, censurable, condemnable, objectionable(malaprobinda)
censurar	censor(cenzuri); censure, criticize(kritiki); reproach, rebuke, reprove, scold(malla?di)
centeno	rye(sekalo)
central	central(centra)
centro	centre(centro); average, mean, middle(mezo)
centímetro	centimetre(centimetro)
cepillar	brush(brosi)
cepillo	brush(broso); plane(rabotilo)
cepillo de dientes	tooth?brush(dentbroso)
cerca	close, near, nearby(proksime)
cercar	bar, obstruct(bari)
cerca de	at, beside, by, near, nearby, near to, nextto(apud); about, approximately(proksimume)
cerda	sow(porkino)
cerdo	hog, pig, swine(porko); boar(virporko)
cerebro	brain(cerbo)
ceremonia	ceremony(ceremonio); ceremony(solena?o)
cereso	cherry?tree(?erizujo)
cereza	cherry(?erizo)
cero	nought, zero(nul)
cerrado	closed, shut(fermita)
cerradura	lock(seruro)
cerrar	close, shut(fermi); lock(?losi)
certificación	certificate, testimony(atesto)
certificado	certificate, testimony(atesto); registered(registrita²); registered(rekomendita²)
certificar	record, register(registri)
cerveza	ale, beer(biero)
cerámica	crockery, earthenware, pottery(argila?o)
cesión	abandonment(cedo)
cesto	basket(korbo)
chal	shawl(?alo)
chaleco	vest, waistcoat(ve?to)
champaña	champagne(?ampano)
champiñon	mushroom(?ampinjono)
champú	shampoo(?ampuo)
chanza	gag, joke(?erco)
chaqueta	jacket(jako)
charco	pool(akvotruo)
charlar	chat, chatter(babili)
chauffeur	chauffeur, driver(?oforo)
checo	Czech(?e?a); Czech(?e?o)
cheque	check, cheque(?eko)
chicle	chewing?gum(ma?gumo)
chico	boy, lad, laddie(knabo); diminutive, little, small(malgranda)
chilena	Chileanwoman(?ilianino)
chileno	Chilean(?ilia); Chilean(?iliano)
chino	Chinese(?ina); Chinaman, Chinese(?ino)
chispa	spark(fajrero); spark(sparko)
chocar kun	collide with, crashinto(koliziikun)
chocolate	chocolate(?okolado)
choque	collision(kolizio)
chuleta	cutlet(kotleto)
chupar	suck(su?i)
chófer	conductor, driver(kondukisto); driver(veturigisto); chauffeur, driver(?oforo)
ciclo	cycle(ciklo¹)
ciclomotor	moped(mopedo)
ciclón	cyclone(ciklono)
ciego	blind(blinda)
cielo	heaven, sky(?ielo)
ciencia	science(scienco)
ciento	hundred, onehundred(cent)
ciertamente	certainly(certe)
cierto	certain, sure(certa); a, any, anybody, some, somebody, one, some one, someone(iu)
cifra	cipher, digit, figure, numeral(cifero)
cigarillo	cigarette(cigaredo)
cigarro	cigar(cigaro)
cilindro	cylinder, roller(cilindro)
cincel	chisel(?izilo)
cinco	five(kvin)
cine	cinema, movietheatre(kinejo)
cinta	bond, tie(ligilo); connection, league(ligo); ribbon(rubando)
cinta pegante	adhesivetape(glubendo)
cinto	belt, girdle(zono¹)
cintura	waist, waistline(talio)
cinturón	belt, girdle(zono¹)
ciprés	cypres(cipreso)
circo	circus(cirko)
circuito	circuit(cirkvito)
circular	circular(cirkulero)
circuncisión	circumcision(cirkumcido)
circunspecto	thoughtful(anta?zorga); careful, cautious(singarda); careful, cautious(singardema); careful, cautious(singardema)
ciruela	plum(pruno)
cirujano	surgeon(?irurgo)
cita	citation, quotation(cita?o); appointment, date, rendezvous(rendevuo)
citación	citation, quotation(cita?o)
citar	cite, quote(citi)
ciudad	city, town(urbo)
ciudadela	citadel(citadelo)
civil	civil, civilian, non?military(civila)
civilización	civilization(civilizacio)
cizalla para setos	hedge clippers, hedgeshears(he?tondilo)
claro	bright, clear, light(hela); clear, distinct, plain(klara)
clase	class(klaso); kind, sort(speco)
clasificar	classify(enklasigi)
clavel	carnation, pink(dianto)
clavo	nail(najlo)
cliente	buyer, client, purchaser(a?etanto); client, customer(kliento)
clientela	clientèle(klientaro)
clima	climate(klimato)
cloaca	sewer(kloako)
cloro	chlorine(kloro)
club	club, society(klubo)
cláusula	clause(kla?zo)
coartada	alibi(alibio)
cobertizo	penthouse, shed(alero); penthouse, shed(anta?tegmento); barrack, barn, shack, shanty, shed(barako); penthouse, shed(markezo)
cobrador	guard(konduktoro)
cobre	copper(kupro)
cocaína	cocaine(kokaino)
cocer	bake(baki)
coche?cama	sleeping?car(litvagono)
coche	car(a?to); carriage, coach(kale?o); carriage, coach, railway carriage, waggon(vagono)
coche remolque	trailer(postveturilo)
cochina	sow(porkino)
cochinillo	piglet(porkido)
cocina	kitchen(kuirejo)
cocinar	cook(kuiri)
cocinera	cook, femalecook(kuiristino)
cocinero	cook, malecook(kuiristo)
cocodrilo	crocodile(krokodilo)
codiciar	covet(avidi)
codicioso	acquisitive, eager, greedy(avida)
codo	elbow(kubuto)
coger	clutch, grab, grasp, grip, seize(ekkapti); clutch, grapple(ekteni); fetch, get, pickup(irpreni); capture, catch, grapple(kapti); get, lay hold of, pick up, take(preni)
cohete	rocket(raketo)
cojear	limp(lami)
cojo	lame(lama)
col	cabbage(brasiko)
cola	glue(glua?o); glue(gluo); tail(vosto)
colcha de cama	bedspread, counterpane, coverlet(litasuperkovrilo)
colchón	mattress(matraco)
colecta	collection(kolektado)
colega	colleague(kolego); colleague(samprofesiano)
colegio	college(kolegio)
coles de Bruselas	Brussels?sprouts(bruselabrasiko)
colgar	droop, hang(pendi); hang(pendigi)
coliflor	cauliflower(florbrasiko)
colina	hill(monteto)
colisión	collision(kolizio)
colocar	invest(investi); lay(ku?igi); lay down, place, put, putdown(meti)
colonia	colony, settlement(kolonio)
color	colour, dye(koloro)
columna	column, pillar(kolono)
comadrona	nurse, dry?nurse, monthlynurse(vindistino)
comandante	boss, chief, leader(estro); commander(komandanto); chief, boss(?efo)
comarca	region(regiono)
combiar	change(?an?i?i)
combinación	combination(kombina?o); undergarment(subvesto)
comedor	dining?room(man?ejo); dining?room(man?o?ambro)
comenzar	begin, commence, start(komenci); begin, commence, start(komenci?i)
comer	lunch(meztagman?i)
comerciante	merchant(komercisto); businessman, merchant(negocisto)
comercio	business, commerce, trade(komerco)
comerse	eatup(forman?i)
comestible	edible(man?ebla)
comestibles	food(man?a?o)
cometer	achieve, act, do, make, perform(fari); accomplish, achieve, keep, observe, perform(plenumi)
comida	meal(man?o); dinner, middaymeal(tagman?o)
comienzo	beginning, commencement, start(komenci?o); beginning, commencement, start(komenco)
comisaría	police?station(policejo)
comisión	commission(komisiono)
comitiva	procession(procesio)
comité	committee(komitato)
communicación	account, communication(komuniko)
como	how, inwhatway(kiel²)
como es debido	decently, properly(dece)
como si	as if, as though, inaway(kvaza?)
compadecer a	have compassion on, pity(kompati)
comparar	compare(kompari)
compartir	divide, separate, share(dividi)
compañero	colleague(kolego); colleague(samprofesiano)
compañía	company(kompanio)
compensar	compensate(kompensi)
competencia	competition(konkurenco)
competidor	rival(rivalo)
competir	compete, rival(konkuri)
complacer	meet with, satisfy(kontentigi)
complekso	complex(komplekso)
completamente	completely, entirely, through(komplete); completely, fully(plene)
completar	complete(kompletigi)
completo	absolute, complete(kompleta); entire, overall, whole(tuta)
componerse	consistof(konsistiel)
compositor	composer(komponisto)
compra	accession, acquisition, asset(akiro); acquisition, purchase(a?etado)
comprador	buyer, client, purchaser(a?etanto); client, customer(kliento)
comprender	understand, realize(kompreni)
comprendido	understood(komprenita)
comprensible	understandable(komprenebla)
compromiso	accommodation(kompromiso)
computador	computer(komputero)
computar	calculate, count, figure, workout(kalkuli)
comunicación	connection(konekto)
comunicar	communicate, report(komuniki); connect, connect up, plugin(konekti)
comunista	communist(komunisto)
comunión	communion(komunio)
común	commonplace, dismal, trite(banala); common, joint(komuna); common, ordinary, usual(ordinara)
con	with(kun)
concernir	concern(koncerni)
concha	shell(konko)
concierto	concert(koncerto)
concisión	brevity, briefness, conciseness(koncizeco)
conciso	concise(konciza)
concluir	accomodate, end, finish, terminate(fini)
conclusión	conclusion, inference(konkludo)
concordación	accord, accordance, agreement, concurrence(akordo¹)
concurso	competition, contest(konkurso)
condenar	condemn, sentence(kondamni)
condición	circumstance(cirkonstanco); condition, stipulation, terms(kondi?o)
condom	condom, rubber(kondomo)
conducir	conduct, guide, lead(konduki); go, ride, travel(veturi)
conducirse	behave, conductoneself(konduti)
conejo	rabbit(kuniklo)
conejo macho	buck, buck?rabbit(virkuniklo)
conexión	relation(rilato)
confección	making, manifacture(fabrikado); making, manufacture(farado)
conferencia	conference(konferenco)
confesar	acknowledge, admit, confess, profess(konfesi¹); confess(konfesi²)
confesión	acknowledgement, admission, confession(konfeso¹); confession(konfeso²)
confianza	confidence(konfido)
confirmación	confirmation(konfirmacio); confirmation(konfirmo)
confirmar	affirm, assent, sayyes(jesi); acknowledge, confirm, corroborate(konfirmi)
confiscar	confiscate(konfiski)
conflicto	conflict(konflikto)
conforme	agreed, okay(konsentite)
congreso	congress, convention(kongreso)
conminación	menace, threat(minaco)
conminar	menace, threaten(minaci)
conmovedor	affecting, moving, touching(emocia); affecting, moving, touching(kortu?a)
conmover	move, stir(emocii); affect, agitate, move(kortu?i)
conmovido	seizedwithemotion(emociita); seizedwithemotion(kortu?ita)
conocido	famous(fama); famous(famkonata); acquaintance(konato)
conocimiento	acquaintance, knowledge(kono)
conocimientos	fame, renown(fameco)
conquistar	conquer(konkeri)
consecuencia	consequence, consistency(konsekvenco)
consecuente	consistent(konsekvenca)
consecutivo	following, next(sekvanta)
conseguir	succeed(sukcesi)
consejero	counsellor(konsilanto)
consejo	advice, counsel(konsilo)
consentir	spoil(trodorloti)
consequir	achieve, acquire, attain, get, obtain(akiri)
conserje	porter(pordisto)
conservación	conservation, maintenance, preservation, retention(konservado)
conservador	conservative(konservativa)
conservar	conserve, keep, maintain, preserve(konservi)
conservatorio	academyofmusic(konservatorio)
considerable	considerable, sizable(konsiderinda)
consideración	consideration, deliberation(konsidero)
considerar	account, consider, esteem, regard, takeintoaccount(konsideri)
consolar	comfort, console(konsoli)
constipado	constipation(mallakso)
constitución	constitution(konstitucio)
construcción	accommodation, adjustment, arrangement(aran?o); building(konstruado); building(konstrua?o)
construir	build, construct(konstrui)
consulado	consulate(konsulejo)
consulta	consultation(konsulto)
consumidor	consumer(konsumanto)
consumir	consume, useup(konsumi)
consumo	demand, sale(debito)
contable	book?keeper(librotenisto)
contacto	contact(kontakto)
contador público	accountant(kontrevizoro)
contagiado	contaminated, infected(infektita)
contagiar	infect(infekti); communicate(konta?i)
contagioso	catching, contagious, infectious(infekta); catching, contagious, infectious(konta?a)
contante	cash, incash(kontanta)
contar	count(nombri); narrate, relate, tell(rakonti)
contemplación	consideration, deliberation(konsidero); examination(rigardado)
contemplar	account, consider, esteem, regard, takeintoaccount(konsideri)
contemporáneo	current, present(nuna); current, present(nuntempa)
contener	bridle, check, restrain(bridi); comprise, contain, include(enhavi); control, govern, restrain, rule(regi)
contento	contented, pleased, satisfied(kontenta)
contestación	answer, reply(respondo)
contestar	answer, reply, respond(respondi)
contestar a	answer(respondial)
contiguo	adjacent(apuda); adjacent, adjoining(limtu?anta); adjacent, nearby, neighbouring(najbara)
continuamente	constantly, continually, continuously(da?re); all the time, ceaselessly(sen?ese)
continuar	continue, hold, last(da?radi); continue, endure, keep on, last(da?ri); continue, go on, proceedwith(da?rigi)
continuo	abiding, lasting(da?ra); constant, continual, permanent, sustained(konstanta); lasting(kontinua); continuous(senhalta); continuous(seninterrompa); constant, lasting, sustained(sen?esa)
contra	across from, against, in exchange for, opposed to, opposite, upon(kontra?)
contradecir	contradict(kontra?diri)
contramandar	cancel, countermand(malmendi); abjure, abolish, abrogate, annul, cancel, remit(nuligi)
contraste	contrast(kontrasto)
contratar	invite tenders for, putouttotender(adjudiki); makeacontract(kontrakti)
contrato	contract(kontrakto)
contribución	tax(imposto)
contribuyente	ratepayer, taxpayer(impostpaganto)
controlar	audit, check, check up on, supervise, verify(kontroli)
conulla	inverted comma, quotation mark, quote(citilo)
conullas	quotation marks, quotes(citiloj); inverted commas, quotation marks, quotes(citsignoj)
convencer	convince, persuade(konvinki)
convenido	agreed, okay(konsentite)
conveniente	decent, fitting, proper, suitable(deca); appropriate, becoming, seemly, suitable(konvena)
convenio	accord, accordance, agreement, concurrence(akordo¹); accommodation, accord, agreement(interkonsento)
convenir	befit, befitting(deci); agree(interkonsenti); be appropriate, suit, besuitable(konveni)
convento	monastery(mona?ejo)
conversar	converse(konversacii)
conversión	conversion(konverti?o)
convertir	convert(konverti)
con motivo de	because of, onaccountof(ka?zede)
copa	goblet(pokalo)
copia	copy(kopio)
copiar	copy(kopii); print(printi)
copla	verse(strofo)
copo de nieve	snowflake(ne?ero)
corazón	heart(koro)
corbata	tie, necktie(kravato)
corcho	cork(korko)
cordel	line(hokfadeno)
cordero	lamb(?afido)
cordillera	chain of mountains, mountain chain, mountain range, rand(monto?eno)
cordón	shoe?lace(?ula?o)
coronar	crown(kroni)
correcto	correct, right(korekta)
corregir	correct(korekti)
correo	mail, post(po?to)
correo aéreo	airmail(aerpo?to)
correr	flow(flui); race, run(kuregi); run(kuri)
corresponder al	answer, answer to, comeupto(estikonformaal); correspondto(estila?)
corriente	current, flow, stream(fluo); current(kurento)
corromper	spoil(malbonigi)
corrupción	corruption(korupteco)
cortacircuito	shortcircuit(fu?kontakto)
cortar	cutoff(detran?i); pick, pluck, tearoff(de?iri); behead, decapitate(senkapigi); clip, cut, shear(tondi); cut, slice(tran?i)
cortesía	politeness(?entileco)
corteza	bark(arbo?elo); bast(basto)
cortina	curtain(kurteno)
corto	short(kurta); brief, short(mallonga)
cortés	courteous, polite, well?mannered(?entila)
corzo	roe(kapreolo)
cosa	thing(a?o)
cosecha	harvest(rikolto)
coser	sew(kudri)
costa	coast, seaside, shore(marbordo)
costar	cost(kosti)
costear	bear the cost of, defray the cost of, paytheexpensesof(pagilakostojnde)
costumbre	custom, habit, way(kutimo)
costura	seam(junto); seam(kunkudro)
costurera	tailor, femaletailor(tajlorino)
coñac	brandy, cognac(konjako)
crecer	accrue, grow(kreski)
creer	account, accredit, believe, deem(kredi); create(krei); think(pensi)
crema	cream(kremo)
cremallera	zipper(zipo)
crema para zapatos	polish, wax(ciro)
crepe	pancake(patkuko)
criada	maid, servant(servistino); maid(?ambristino)
criado	boy, servant(servisto)
crimen	crime(krimo)
crisis	crisis, depression, emergency(krizo)
cristianismo	Christianity(kristaneco)
cristiano	Christian(kristana); Christian(kristano)
criticar	censure, criticize(kritiki); judge(priju?i)
cruce	crossroads(vojkruci?o)
crudo	crude, raw, rough(kruda); raw, uncooked(nekuirita)
cruz	cross(kruco)
cráneo	skull(kranio)
crítica	criticism(kritiko)
crítico	alarming, grave, serious(maltrankviliga)
cuadra	stable, stall, sty(stalo)
cuadro	bed(bedo); painting, picture(pentra?o)
cuartel	barracks(kazerno); barracks(soldatejo)
cuarto	apartment, flat(apartamento); fourth(kvara); fourth(kvarono); chamber, room(?ambro)
cuarto de baño	bathroom(ban?ambro)
cuatro	four(kvar)
cubierta	deck(ferdeko)
cubierto	forks, knivesandspoons(man?ilaro)
cubierto de verdor	covered, grown over, overgrown(surkreskata)
cubo	bucket, pail(sitelo)
cubrir	cover(kovri)
cucaracha	cockroach(blato)
cuchara	spoon(kulero)
cuchichear	whisper(flustri)
cuchillo	knife(tran?ilo)
cuello	neck(kolo); collar(kolumo)
cuenta	account, bill, invoice(fakturo); account, bill, calculation(kalkulo); account(konto)
cuenta bancaria	bank account, bankingaccount(bankokonto)
cuerda	cord, rope, string(?nuro)
cuerno	horn(korno¹)
cuero	leather(ledo)
cuerpo	body(korpo)
cuervo	raven(korako)
cuesta	acclivity, hillside, slope(deklivo)
cuesta abajo	down the slope, downhill(montsuben)
cueva	cave, grotto(groto); cave, cavern, den(kaverno)
cuidado	care, concern(zorgo)
cuidar	attend, nurse, tendto(flegi); care, see, take care, worry(zorgi)
cuidarse de	care about, takecareof(zorgipri)
cuidar de	lookafter(prizorgi)
culpa	blame, fault, guilt(kulpo)
culpable	guilty(kulpa)
cultivar	cultivate, grow(kulturi); plant(planti)
cultivo	planting(plantado)
culto	service, worshipservice(diservo)
cultura	culture(kulturo)
cumpleaños	birthday(naski?tago)
cumplimiento	replacement, replenishment, supplement(kompletigo); compliment(komplimento)
cuna	cradle, placeofbirth(naski?ejo)
cuota	dues, subscription(kotizo)
cupón	coupon(kupono)
cura	treatment(kuracado); pastor, vicar(paro?estro); clergyman, pastor, priest(pastro)
curar	care for, cure, treat(kuraci); cure, heal, remedy(resanigi); cure, heal, remedy(sanigi)
curioso	agog, curious, inquisitive(scivola)
cursillo	class, course(kurso)
curso	class, course(kurso); exchange rate, rateofexchange(kurzo)
curva	bend, curve(kurbo)
curvar	bend(fleksi); bend(kurbigi)
cáliz	goblet(pokalo)
cámara	camera(fotilo); camera(kamerao)
cámara de películas	camera(kamerao)
cándido	guileless, inoffensive(senmalica)
cápsula	capsule, firing?cap(kapsulo)
cáscara	bark, husk, peel, shell(?elo)
célula	cell(?elo)
címbalo	cymbal(cimbalo)
cínico	cynical(cinika)
círculo	circle(cirklo)
cítara	zither(citro)
código	code(kodo)
cólera	cholera(?olero)
cómico	amusing, entertaining, funny(amuza)
cómo	how, inwhatway(kiel¹)
cómodo	homy(hejmeca); close, intimate(intima)
cónsul	consul(konsulo)
dado que	supposingthat(supozeke)
dama	lady(sinjorino¹)
damas	checkers(damludo); checkers(damoj)
danés	Danish(dana); Dane(dano)
dar	give(doni)
darse de baja	quit, resign(eksi?i)
darse tono	attitudinize, pose, putonairs(afekti)
dar a destajo	invite tenders for, putouttotender(adjudiki)
dar a la bomba	pump(pumpi)
dar a luz	bear, givebirthto(naski)
dar dentelladas a	snap at, snarl at, snub(ripro?imalafable)
dar de comer	feed(man?igi)
dar el pésame a	expresscondolences(kondolenci)
dar gracias a	thank(danki)
dar la bienvenida	welcome(bonvenigi)
dar lugar a	cause, causetotakeplace(okazigi)
dar parte de	issue, proclaim(proklami)
dañar a	be detrimental to, detract from, doharmto(malservi); harm(malutili)
daño	damage(dama?o); damage(difekto); harm(malutilo)
de	from, of(de¹); from, outof(el)
debajo de	below, beneath, under, underneath(sub)
deber	duty, obligation(devo); owe(?uldi)
debutante	beginner(komencanto)
decadencia	decay(ruini?o)
decentar	cutinto(ektran?i); begin, commence, start(komenci)
decidirse	decide(decidi)
decir	say, tell(diri)
decisivo	decisive(decida)
decisión	decision(decido)
declaración	declaration, proclamation, statement(deklaro); acknowledgement, admission, confession(konfeso¹); agreement, consent, permission(konsento)
declarar	declare, state(deklari); acknowledge, admit, confess, profess(konfesi¹); accede, agree, consent(konsenti)
declararse en huelga	strike(striki)
decorar	adorn, decorate, ornament(ornami)
decrecer	abate, decrease, diminish, drop, fall(malplii?i)
decrépito	decayed, decrepit, dilapidated, lapsed, rickety(kaduka)
decudir	abstract, deduce, gather(dedukti); abstract, induce, gather, infer(konkludi)
decímetro	decimetre(decimetro)
dedo	finger(fingro)
dedo de pie	toe(piedfingro)
deducción	demand, sale(depreno)
deducir	countdown(dekalkuli)
defecto	damage(difekto)
defender	protect(protekti)
defensa	defence, defense(defendo); protection(protektado)
definir	define, determine(difini)
dejar	allow, leave, let, release(lasi); leavebehind(postlasi)
dejar en pos	leavebehind(postlasi)
dejo	accent(prononcmaniero)
delante	ahead, formerly, previously(anta?e)
delante de	before, infrontof(anta?)
delatar	accuse, denounce(denunci)
delegar	delegate(delegi); depute(deputi)
deletrear	spell(literumi)
demandar	ask, ask for, beg, bid, request(peti)
demasiado	too, toomuch(tro)
demoler	break down, demolish, pull down, takedown(malkonstrui)
demolición	demolition(malkonstruado); demolition(malkonstruo)
demontar	takeapart(malmunti)
demostrable	apparent(montrebla)
demás	besides, in addition, moreover(kromtio)
dengoso	prudish(pruda)
dentista	dentist(dentisto)
dentro	inside(interne)
dentro de	a, in, inside, into, on, per, within(en); inside, within(internede)
denuncia	accusation(denunco)
denunciar	accuse(akuzi); accuse, denounce(denunci); accuse(plendikontra?)
departamento	compartment, coupé(kupeo); section(sekcio)
departamento de fumar	smokers(fumkupeo)
dependencia	dependence(dependeco)
depender	depend(dependi)
depender de	be dependent on, dependonldependupon(dependide)
dependienta	saleswoman(vendistino)
dependiente	dependent(dependa); clerk(komizo)
deplorable	regrettable(beda?rinda); dismal, miserable, pitiful, poor(kompatinda)
deplorar	be sorry about, regret(beda?ri); begrudge, regret(doma?i); mourn(priplori)
deporte	sport(sporto)
depositar	deposit(deponi)
depósito	depository(deponejo)
depósito de gasolina	gas tank, petroltank(benzinujo); fueltank(kanistro)
derecho	claim, presumption, pretence(pretendo); right(rajto); direct, straight(rekta)
derechos de consumo	excise, excise?duty(akcizo)
derivación	derivation(deriva?o)
derivar	derive(derivi)
derivar del rumbo	drift, beadrift(drivi)
derramar	pour, scatter, shed(ver?i)
derretir	melt(fandi)
derretirse	melt(fandi?i)
derribar	break down, demolish, pull down, takedown(malkonstrui)
derribos	rubbish, oldmaterials(ruboj)
derrota	defeat(malvenko)
derruirse	crumble, crumble away, crumbleoff(peceti?i)
desaconsejar	advise against, dissuadefrom(malkonsili)
desacostumbrar	break of a habit, teach(dekutimigi)
desagüe	draining(drenado)
desanimado	dejected, depressed(korpremita)
desaprender	unlearn(mallerni)
desaprobación	censure, condemnation, disapprobation, disapproval(malaprobo)
desaprobar	condemn, disapprove, disapprove of, rebuke(malaprobi); reproach, rebuke, reprove, scold(malla?di)
desarrollar	account for, explain(ekspliki); account for, clarify, explain(klarigi)
desatinar	drivel, twaddle(parolisensence)
desayuno	breakfast(matenman?o)
descalzo	barefoot(nudpieda)
descansar	repose, rest(ripozi)
descanso	break, intermission, pause, recess(pa?zo); repose, rest(ripozo)
descargar	writeoff(deprezi); abreact(forreagi); unload(mal?ar?i)
descendencia	lineage(deveno); origin(origino)
descender	accrue, come, derive, originate, result(deveni); descend, get off, godown(malsupreniri)
descendiente	offspring, successor(posteulo)
descolgar	abstract, takeaway(forpreni)
desconcharse	flake off, peel off, scaleoff(deskvami?i)
desconocido	unknown(nekonata)
descortés	rude(mal?entila)
describir	describe(priskribi)
descripción	account, description(priskribo)
descubrimiento	discovery(malkovro)
descubrir	discover, uncover(malkovri)
descuento	abatement, discount, rebate(rabato)
descuidado	careless, negligent(neatenta); careless, negligent(senatenta)
descuidar	neglect(neglekti)
desde	from, since(ekde)
desear	ache(deziregi); desire, wish(deziri)
desechos	clippings, cuttings, parings, refuse, rubbish, waste, windfall(defala?o); remainder, rest(resta?o); debris, rubbish, rubble(rubo)
desembarcadero	landing?stage, pier(albordi?ejo); landing?stage, pier(navighaltejo); landing?stage, pier(varfo)
desembocadura	mouth(enfluejo)
desempeñar	occupy, take(okupi)
desenfrenado	lawless, licentious, riotous(senbrida)
desentenderse de	ignore, leaveoutofaccount(ignori)
deseo	avidity, covetousness, eagerness, greediness(avido); desire, want, wish(deziro)
deserción	apostasy, defection(malfideli?o)
desertar	apostatize, desert, secede(malfideli?i)
desfiladero	pass(montpasejo)
desgastarse	wear away, wear off, wearout(eluzi?i)
desgracia	accident(akcidento)
desgraciadamente	unfortunately(malbon?ance); unfortunately(malfeli?e)
deshielo	melting, thaw(degelo)
deshonesto	nasty(malhonesta)
desierto	desert(dezerto)
designar	indicate, suggest(indiki); indicate, point out, show(montri)
desigual	bumpy(malebena); different(malegala); coarse, rough(malglata)
desinteresado	disinterested(neprofitema)
desistir de	relinquish, renounce, waive(rezignipri)
deslumbar	dazzle(lum?eni)
desmayado	unconscious(senkonscia)
desmayarse	faint, swoon(sveni)
desmayo	faint, swoon(sveno)
desmejorarse	decline, go back, falloff(malpliboni?i)
desmoronarse	crumble, crumble away, crumbleoff(peceti?i)
desnatar	cream, skim(senkremigi)
desnudo	bare, naked, nude(nuda)
despachar	dispatch, send off, ship(ekspedi); conclude, dispatch, expedite, finnish, settle(finaran?i); dismiss, turnaway(forsendi); send, transmit(sendi)
despacho	demand, sale(debito)
despedida	farewell, goodbye, good?bye(adia?o)
despedir	dismiss, turnaway(forsendi); discharge, dismiss, fire, sack(maldungi); discard(uzofini)
despedirse	say goodbye, say goodbye to, take leave, takeleavefrom(adia?i)
despeñadero	abyss, chasm, gulf, precipice(abismo)
despojar	rob(prirabi)
despreciar	despise(malestimi)
desprecio	contempt(malestimo)
desprendimiento de tierras	landslide(grundadisfalo); landslide(ter?ovi?o)
despuntar	blunt(malakrigi)
después	after, behind(post); afterwards, next, subsequently(poste); beyond, next, then, thereafter(posttio)
destajar	makeacontract(kontrakti)
destajista	builder, contractor, building contractor, masterbuilder(konstruentreprenisto)
destajo	contract(kontrakto); tender(prezkonkurado)
desterrado	exile(ekzilito)
destierro	exile(ekzilo)
destinatario	consignee, recipient(ricevanto)
destino	destiny, fate(destino)
destituir	depose(detronigi)
destornillador	screwdriver(?ra?bturnilo)
destreza	expertness, skilfulness, skill, skillfulness(lerteco)
destruir	destroy, quash(detrui)
desviar	divert(forkonduki)
desviarse	deviate(deklini?i); turn(devii); deflect, diverge, wander(flankeni?i)
desván	attic(subtegmento)
desvío	aberrance, aberration(devio)
detalle	detail(detalo)
detective	detective(detektivo)
detención	apprehension, arrest, detention(arestado); apprehension, arrest, detention(aresto)
detener	arrest(aresti)
detenido	arrested person, prisoner(arestito)
deterioración	corruption, decay, depravation, taint(malboni?o); decay(putri?o)
deteriorar	damage, injure, spoil(difekti)
deterioro	damage(difekto)
determinar	determine, fix(determini)
detestar	abhor, abominate, loathe(abomeni)
detrimento	harm(malutilo)
detrito	clippings, cuttings, parings, refuse, rubbish, waste, windfall(defala?o); remainder, rest(resta?o); debris, rubbish, rubble(rubo)
detrás	at the back, behind, intherear(jelafino); behind(malanta?e)
detrás de	behind, after(malanta?)
deuda	debt(?uldo)
deudo	relative(parenco)
devanar	unroll, unwind, windoff(malbobeni); unroll(malvolvi)
devolver	give back, return(redoni)
de acuerdo	agreed, okay(konsentite)
de aire acondicionado	airconditioned(aerklimatizita)
de confianza	reliable, trustworthy(fidinda)
de cuando en cuando	nowandthen(detempoaltempo)
de dia	by day, duringtheday(dumtage); by day, during the day, inthedaytime(tage)
de espaldas	backward, onone'sback(dorsen); backwards(posten)
de golpe	all of a sudden, suddenly(subite)
de hierro	iron(fera)
de madera	wooden(ligna)
de mala fama	ofillrepute(fifama)
de memoria	byheart(parkere)
de nilón	nylon(nilona)
de ninguna manera	by no means, in no way, not at all, notonanyaccount(neniel)
de ningún modo	notatall(tutene)
de nuevo	afresh, again, all over again, anew(denove); afresh, again, oncemore(ree)
de otra manera	differently, else(alie); differently(alimaniere)
de paso	bytheway(parenteze)
de poca profundidad	shallow, superficial(malprofunda)
de prisa	fast, quickly, swiftly(rapide)
de propósito	deliberately, onpurpose(intence)
de repente	all of a sudden, suddenly(subite)
de segunda mano	second hand, secondhand(brokanta)
de sopetón	all of a sudden, suddenly(subite)
de todos los días	daily(?iutaga)
de veras	absolutely, genuinly, indeed, really, truly(vere)
diabetes	diabetes(diabeto)
diamante	diamond(diamanto)
diariamente	daily(?iutage)
diario	daily(?iutaga)
diarrea	diarrhoea(diareo)
dibujar	design, draw(desegni)
diccionario	dictionary, vocabulary(vortaro)
dicho	concerned, inquestion(koncerna)
diciembre	December(decembro)
dieciocho	eighteen(dekok)
diestro	adroit, clever, dexterous, skillful(lerta)
dieta	diet(dieto)
dietario	agenda, appointmentbook(agendo)
diez	ten(dek)
diez y nueve	nineteen(dekna?)
diez y ocho	eighteen(dekok)
diez y seis	sixteen(dekses)
diez y siete	seventeen(deksep)
diferencia	difference(diferenco)
diferente	different(diferenca)
diferir	differ, bedifferent(diferenci)
dificil	difficult, hard, inconvenient(malfacila)
dificultar	hamper, hinder, thwart(malfaciligi)
difundir	send, transmit(sendi)
digestión	digestion(digesto)
digresar	stray from one's subject, wanderfromone'ssubject(detemi?i)
dimensión	dimension, measurement(dimensio)
dimitir	resign(demisii); quit, resign(eksi?i)
dinamarqués	Danish(dana); Dane(dano)
dinero	money(mono)
dinero del embase	pledge, security(garantia?o)
diputado	delegate(delegito); delegate, deputy, representative(deputito)
diputar	delegate(delegi); depute(deputi)
dirección	address(adreso); direction(direkto)
directamente	at once, instantly, immediately, withoutdelay(senprokraste)
director	director, manager(direktoro)
directorio	addresslist(adresaro)
dirigir	address(adresi); conduct, guide, lead(konduki)
dirigirse	go(iri)
dirigirse a	accost, address(alparoli)
dirigir la palabra a	accost, address(alparoli)
disco	grammophonedisc(gramofondisko)
discreto	discrete(diskreta)
discriminación	discrimination(diskriminacio)
disculpa	apology(ekskuzo)
disculparse	apologize(senkulpigisin)
disferente	different(diferenca)
disfrutar	delight in, enjoy(?ui)
disminuir	abate, decrease, diminish(malkreski); abate, decrease, diminish, drop, fall(malplii?i)
disponible	available(disponebla)
disposición	ability, capability, fitness, suitability(ta?geco)
disputar	quarrel, wrangle(kvereli)
dispénseme	excuseme(pardonu)
distancia	distance, offset(distanco)
distinguir	distinguish(distingi)
distinto	different(diferenca); different(malsama)
distracción	distraction, diversion(distra?o); distraction, diversion(distro)
distraer	distract, divert, entertain(distri)
distraído	absent?minded, abstracted, distracted(distrita)
distribuir	distribute(distribui)
distrito	district(distrikto)
divergente	different(diferenca)
diversión	amusement, fun(amuzo)
divertido	amusing, entertaining, funny(amuza)
divertimento	amusement, fun(amuzo)
divertir	amuse(amuzi)
divertirse	enjoy oneself, haveagoodtime(amuzi?i)
dividir	divide, separate, share(dividi)
divorcio	divorce(eksedzi?o)
divulgar	publish, reveal(publikigi); acquaint, let know, inform(sciigi)
diámetro	diameter(diametro)
doblar	fold(faldi); bend(fleksi); bend(kurbigi)
doble	double, dual(duobla)
doce	twelve(dekdu)
doctor	doctor, physician(kuracisto)
documento	document, paper(dokumento)
doler	ache, be painful, hurt(dolori)
dolerse por	have compassion on, pity(kompati)
dolor	ache, pain(doloro)
dolor de muelas	toothache(dentdoloro)
domesticado	tame(malsova?a)
domicilio	abode, dwelling?place, residence(domicilo); abode, dwelling?place?residence(lo?loko)
dominga de Ramos	PalmSunday(Palmofesto)
domingo	Sunday(diman?o)
donde	where(kie¹)
dormir	be asleep, sleep(dormi)
dos	two(du)
dosis	dose(dozo)
dos veces	twice(dufoje)
dotado	gifted, talented(naturdotita); accomplished, talented(talenta); gifted, talented(talentplena)
dotar	endow(doti)
dromedario	dromedary(dromedaro)
ducha	shower(du?o)
ducharse	takeashower(du?isin)
duda	hesitation, wavering(hezitado); hesitation(hezito)
dudar	doubt(dubi)
dueño	boss, chief, leader(estro); boss, master(mastro); owner(proprietulo)
dueño de sí mismo	composed, restrained, self?possessed(sinrega)
dulce	gentle, soft, sweet, tender(dol?a); delicacy, tidbit, sweet(franda?o)
durar	continue, endure, keep on, last(da?ri)
duro	hard(dura); leather(leda); hard(malmola)
dyschatell	couch, divan(divano)
dátil	date(daktilo¹)
débil	faint, light, weak(malforta)
día	day(tago)
día del Corpus	CorpusChristi(SakramentaTago)
dólar	dollar(dolaro)
dómine	pastor(pastoro)
ebrio	drunk, intoxicated(ebria)
echar	throw(?eti)
echar a perder	spoil(malbonigi)
echar la siesta	doze, nap, slumber(dormeti)
económico	thrifty(?parema)
edad	age(a?o)
edad media	MiddleAges(Mezepoko)
edecán	adjutant, aide?de?camp(adjutanto)
edificar	erect, establish(establi); erect, establish, found(fondi); build, construct(konstrui)
edificio	building(konstrua?o)
edificio anexo	annexation(anekso)
editor	publisher(eldonisto)
eficaz	effective, effectual, efficacious(efika)
efigie	effigy, head(monerfiguro)
egipcio	Egyptian(egipta); Egyptian(egipto)
egipcíaco	Egyptian(egipta); Egyptian(egipto)
egoísta	self?interested, selfish(egoisma); self?interested, selfish(egoista)
eje	axis, axle(akso)
ejemplo	example(ekzemplo)
ejercicio	exercise, practice(ekzerco)
ejército	army(armeo); army(militistaro)
el	the(la)
elección	choice, election(elekto)
electricidad	electricity(elektro)
elefante	elephant(elefanto)
elegante	elegant(eleganta); chic(?ika)
elegir	choose, elect, pickout(elekti)
elevación	altitude, height(alto)
ella	her, she(?i)
eléctrico	electric(elektra)
el día de Todos los Santos	AllSouls'Day(TagodelaMortintoj)
embajada	embassy(ambasadejo); embassy(ambasado)
embajador	ambassador(ambasadoro); ambassador, emissary, envoy, messenger(sendito)
embalsamar	embalm(balzami); embalm(enbalzamigi)
embarcación	ship, vessel(?ipo)
embarcarse	embark(en?ipi?i)
embargar	confiscate(konfiski)
embelesar	charm(?armi)
embotado	blunt(malakra); dull, obtuse(obtuza)
embragar	couple(kupli)
embriaguez	drunkenness, inebriety(ebrieco)
embudo	funnel(funelo)
embuste	swindle(trompo)
embustero	cheat, deceiver, imposter(trompanto)
emigrar	emigrate(elmigri)
emigrarse	emigrate(elmigri)
emoción	emotion(emocio)
empacar	pack, package, wrapup(enpaki)
empalmar	correspond(kunrespondi)
empalme	connection(kunrespondo)
empezar	begin, commence, start(komenci); begin, commence, start(komenci?i)
empleado	employee(dungito); clerk(komizo); officer, official(oficisto)
emplear	apply, practice(apliki)
empleo	post(posteno)
emprender	undertake(entrepreni)
empresa	industry(industrio)
empujar	push, thrust(pu?i)
en	a, in, inside, into, on, per, within(en); on, upon(sur)
enamorarse de	fallinlovewith(enami?ial)
encadenación	order(sinsekvo)
encadenamiento	order(sinsekvo)
encajar	palmoffon(persvadia?eti)
encaje	lace(punto)
encamado	bedridden, confined to one's bed, laidup(litmalsana)
encantador	charming, lovely(?arma)
encantar	attract, draw(allogi); charm(?armi)
encanto	charm(?armo)
encargarse de	undertake(entrepreni)
encendedor	lighter(fajrilo)
encender	burn(bruligi); kindle, light(ekbruligi); light(eklumigi); illuminate, light(lumigi)
encentar	cutinto(ektran?i)
enciclopedia	encyclopaedia(enciklopedio)
encima de	above, over(super)
encogido	afraid, timid(timema)
encontrar	come across, encounter, meet, see(renkonti); find(trovi)
encontrarse	be found, be located, findoneself(trovi?i); be found, be located, findoneself(trovisin)
encuadernación	binding, cover(binda?o)
encuentro	encounter(renkonto)
encuesta	inquiry, investigation(enketo)
encía	gum(dentkarno)
endrino	sledge, sleigh(glitveturilo); sledge, sleigh(sledo)
enemigo	adversary, enemy(malamiko)
enero	January(januaro)
enfermedad venérea	venerealdisease(venereamalsano)
enfermera	nurse(flegistino)
enfrenar	brake(bremsi)
enfrente de	opposite(fronteal); opposite(kontra?ede)
enfriar	cool, cooldown(malplivarmigi); getcold(malplivarmi?i)
engañar	fool, hoax, mystify, trick(mistifiki); takein(trompeti); cheat, deceive(trompi)
engaño	swindle(trompo)
engañoso	deceptive, delusive, fallacious(erariga); deceitful(trompa)
enjugar	dry(sekigi); delete, wipe, wipeoff(vi?i)
enlace	startingpoint(komencloko); connection(kunrespondo)
enmohecerse	getmouldy(?imi)
enorme	enormous(enorma)
enrollar	envelop(envolvi)
ensalada	salad(salato)
ensangrentado	blood?stained, coveredwithblood(sangokovrita); blood?stained, coveredwithblood(sangomakulita)
enseñar	indicate, suggest(indiki); teach(instrui); teach(lernigi); indicate, point out, show(montri)
enteblar	begin, commence, start(komenci)
entender	understand, realize(kompreni)
enteramente	at all, entirely, quite, wholly(tute)
entero	entire, overall, whole(tuta)
enterramiento	burial, funeral, interment(enterigo); burial, funeral, interment(entombigo)
enterrar	bury(enterigi); bury, entomb, inter(entombigi); flood, overwhelm(super?uti)
entierro	burial, funeral, interment(enterigo); burial, funeral, interment(entombigo)
entonar	intone, raise(ekkanti)
entonces	then(tiam); then(tiuokaze)
entrada	entrance, portal(enirejo); access, admission, admittance(eniro)
entrante	future(estonta); close, near, nearby, next(proksima); following, next(sekvonta); next(venonta)
entrar	go in, enter, perform(eniri)
entrar en cuenta	be considered, count(estikonsiderata)
entre	among, between(inter)
entrecortado	broken(rompita)
entrega	delivery(livero); delivery(transdono)
entregar	hand, handover(enmanigi); deliver, furnish, supply(liveri); pass, spend(pasigi); convey, hand, hand over, pass(transdoni)
entretener	amuse(amuzi)
entristecer	afflict, grieve(aflikti); afflict, cause pain, cause pain to, distress, givepainto(mal?ojigi)
envejecer	be on the decline, go downhill, gooff(kaduki?i)
envenenar	poison(veneni)
enviar	dispatch, send off, ship(ekspedi); dismiss, turnaway(forsendi); send, transmit(sendi)
envidia	envy(envio)
envidiar	envy(envii)
envidioso	envious(envia)
envolver	pack, package, wrapup(enpaki)
en alta voz	loudly(la?te)
en casa	athome(hejme)
en cuanto a	about, concerning(koncerne); about, concerning, on, upon(pri); as to, as regards, concerning(rilate)
en cuestón	concerned, inquestion(koncerna)
en efecto	absolutely, actually, infact(efektive); absolutely, genuinly, indeed, really, truly(vere)
en el acto	at once, immediately, just, right away, rightnow(tuj)
en el extranjero	abroad(alilande)
en el fondo	below, downstairs, underneath(malsupre)
en ninguna parte	nowhere(nenie)
en orden	agreed, okay(konsentite)
en otra parte	elsewhere(aliloke)
en parte	partially, partly(parte)
en pos	at the back, behind, intherear(jelafino); behind(malanta?e)
en primer lugar	first, firstly, firstofall(unue)
en principio	inprinciple(principe)
en realidad	absolutely, genuinly, indeed, really, truly(vere)
en seguida	at once, instantly, immediately, withoutdelay(senprokraste); at once, immediately, just, right away, rightnow(tuj)
en su mayor parte	for the greater part, forthemostpart(grandparte); for the greater part, forthemostpart(?efparte)
en todas partes	all about, everywhere(?ie); everywhere(?iuloke)
en todos conceptos	ineveryway(?iel); in all respects, in every respect, ineveryway(?iurilate)
en torno de	about, round, around, towards(?irka?)
en un principio	at first, at the outset, inthebeginning(enlakomenco); at first, at the outset, inthebeginning(komence)
en vano	invain(vane)
equipaje	baggage, luggage(paka?o)
equipajes	baggage, luggage(paka?o)
equis	X(ikso)
equivocación	aberration, error, mistake(eraro)
equivocarse	err, makeamistake(erari)
error	aberration, error, mistake(eraro)
escala	ladder(?tupetaro)
escalar	ascend, climb, scale(surgrimpi)
escalera	staircase, stairs(?tuparo)
escama	scale(skvamo)
escandaloso	aggravating(indigniga)
escandálo	offence, scandal(indigno); commotion, scandal(skandalo)
escaparate	showwindow(montrofenestro)
escarola	endive(endivio)
escarpado	abrupt, steep(kruta)
escaño	bank(banko)
esclusa	lock, sluice(kluzo)
escocés	Scottish(skota); Scot, Scotsman(skoto)
escoger	choose, elect, pickout(elekti)
escombro	mackerel(skombro)
escopeta	gun, rifle(fusilo)
escribir	write(skribi)
escribir a máquina	type(tajpi)
escrupuloso	accurate, scrupulous(skrupula)
escuchar	listen(a?skulti)
escuela	school(lernejo)
escultor	sculptor(skulptisto)
escupir	spit(kra?i); spit(sputi)
esforzarse por	aim, attempt, endeavour, take steps, undertake(klopodi)
eslavo	Slavic(slava); Slav(slavo)
eso	that, that over there, those(tio)
espacio	room, space(spaco)
espalda	back(dorso)
espantar	deter, discourage, scare(fortimigi)
espanto	fright(timego)
esparadrapo	plaster(plastro)
español	Spanish(hispana); Spanish, Spanishlanguage(hispanalingvo); Spaniard(hispano)
española	Spanishwoman(hispanino)
especia	spice(spico)
especial	particular, special(speciala)
especie	kind, sort(speco)
espejo	looking?glass, mirror(spegulo)
esperanto	Esperanto(esperanto)
esperanza	hope(espero)
esperar	foresee(anta?vidi); abide, expect, wait, await, waitfor(atendi); hope(esperi); bide, abide, stay for, wait, await, waitfor(?isatendi)
espiga	ear(spiko)
espinaca	spinach(spinaco)
espina dorsal	spine(spino)
espolear	encourage, impel, instigate, spur on, stimulate, urge(instigi); incite, rouse, spur, stimulate, stirup(sproni)
esponja	sponge(spongo)
esposa	wife(edzino)
esposo	husband(edzo)
espuma	foam, froth(?a?mo)
esputo	mucus, phlegm(muko)
espárrago	asparagus(asparago)
esqueleto	skeleton(ostaro); skeleton(skeleto)
esquiar	ski(skii)
esquimal	Eskimo(eskimo)
esquina	corner(angulo²)
esquí	ski(skio)
esta	these, this, thishere(tio?i); these, this, thishere(?itio)
establo	stable, stall, sty(stalo)
estación	season(sezono); station(stacidomo)
estación balnearia	spa(banurbo)
estación de servicio	fillingstation(benzinstacio)
estado	state(?tato)
estafar	fleece(tropagigi)
estandarte	flag, standard(standardo)
estanque	pond(lageto)
estar	be(esti¹); be(esti²); be found, be located, findoneself(trovi?i)
estar ...ando	busyoneself(esti...anta)
estar de acuerdo con	agreeto(konsentipri)
estar de pie	stand(stari)
estar sentado	sit(sidi)
estar tendido	lie, recline(ku?i)
estatua	statue(statuo)
esta mañana	thismorning(hodia?matene)
esta tarde	thisevening(hodia?vespere)
estaño	tin(stano)
este	east, East(oriento)
estima	esteem, regard(estimo); esteem, regard, respect(?atateco)
estimación	esteem, regard(estimo); esteem, regard, respect(?atateco)
estimar	esteem, thinkwellof(estimi); appraise, estimate, rate(taksi)
estimular	rouse, stimulate, stirup(stimuli)
estipular	set conditions, stipulate(kondi?i)
estofado de carne húngaro	goulash, stew(gula?o)
estorbar	bar, inhibit, prevent(malebligi); bar, hinder, inhibit, prevent(malhelpi)
estornudar	sneeze(terni)
estrecho	narrow(mallar?a); close, cramped(malvasta); strait(markolo)
estrella	star(stelo)
estrofa	verse(strofo)
estropeado	broken, damaged(difektita)
estuche	jug, box, container, vessel(ujo)
estudiante	academic, student(studento)
estudiar	learn(lerni); study(studi)
estudio	study(studo)
estufa	furnace, kiln, oven, stove(forno)
estómago	stomach(stomako)
es decir	thatis(tioestas)
es una lástima	alas, regrettably, unfortunately(beda?rinde); that's too bad, whatapity(doma?e)
europeo	European(e?ropa); European(e?ropano)
evidente	clear, distinct, plain(klara)
evidentemente	apparently, obviously(evidente)
evitar	avoid, evade(eviti)
exacción	exaction, extortion(eldevigo)
exacto	exact(ekzakta)
exagerar	exaggerate(troigi)
examen	investigation, examination, test(ekzameno)
examinar	examine(ekzameni)
excelente	fine, great(bonega)
excepto	apart from, but, except, otherthan(escepte)
excluir	exclude(ekskludi)
excursión	excursion, outing, sightseeingtrip(ekskurso)
excusado	toilet(necesejo)
exhortación	admonition, exhortation(admono)
exhortar	admonish, scold(admoni)
exigir	demand, postulate, require(postuli)
existencia	existence(ekzisto)
existir	exist(ekzisti)
expedir	dispatch, send off, ship(ekspedi); dismiss, turnaway(forsendi)
experiencia	experience(sperto)
experto	experienced, expert, skilful, skilled, skillful, practised(ekzercita); adroit, clever, dexterous, skillful(lerta)
expiración	end, terminate(fini?o)
expirar	end, come to an end, end up, expire(fini?i)
explicación	account, explanation(ekspliko); account, explanation(klarigo)
explicar	account for, explain(ekspliki); account for, clarify, explain(klarigi)
explotar	exploit, utilize(ekspluati)
exposición	exhibition, exposition(ekspozicio)
exterior	external, outer, outside(ekstera)
externo	external, outer, outside(ekstera)
extorsión	exaction, extortion(eldevigo)
extra	additional, extra(ekstra)
extracto	extract, infusion(infuza?o)
extranjero	alien, foreigner(alilandano); alien, foreign(eksterlanda); foreigner(eksterlandano)
extraviarse	go astray, strayoff(devoji?i)
extremamente	extremely(ekstreme); most(plej)
fabricación	making, manifacture(fabrikado); making, manufacture(farado)
fabricar	fabricate, manufacture(fabriki); achieve, act, do, make, perform(fari)
faisán	pheasant(fazano)
falaz	deceptive, delusive, fallacious(erariga); deceitful(trompa)
falda	skirt(jupo)
falta	absence, lack, shortage, shortcoming(manko)
faltar	be lacking, bemissing(manki)
familia	family(familio)
familiar	relative(parenco)
famoso	famous(fama); famous(famkonata); famous, glorious(glora); famous(renoma)
fardo	bale(pakego)
farmacia	chemist's shop, drugstore(apoteko)
farmacéutico	chemist(apotekisto)
faro	headlight(reflektoro)
farol	lantern(lanterno)
farsante	attitudinizer, poseur(afektulo)
fatal	fateful, ill?fated(fatala)
fatigar	fag out, jade, overdrive, override(lacegigi)
favor	favor, favour(favoro)
favorable	advantageous, favourable(favora)
favorecer	favor, favour(favori)
faz	face(viza?o)
febrero	February(februaro)
fecha	date(dato)
federal	federal(federala)
felicitar	congratulate(gratuli)
feminino	female, feminine(ina)
fender	split(fendi)
fenomenal	phenomenal(fenomena)
feo	nasty, ugly(malbela)
fidedigno	plausible(kredebla); plausible(kredinda)
fiebre	ague, fever(febro)
fiel	faithful(fidela)
fiero	savage, wild(sova?a)
fiesta	celebration, festival, party(festo)
figurado	figurative(figura)
figurarse	fancy, imagine(imagi)
fijar	attach, determine, fasten, fix, affix, make fast, secure(fiksi)
fijo	fixed(fiksa); fast, firm, stable(firma)
fila	grade, rank, rate(rango)
filete	slice(tran?a?o)
filtro	filter(filtrilo)
fin	aim, goal, purpose, target(celo); end, ending(fino)
final	end, ending(fino)
finalmente	at last, finally, ultimately(fine)
finca	estate, farm, property, ranch(bieno)
finesa	Finnish, Finnishwoman(finnino)
fingir	give as an excuse, pretend(preteksti); feign, pretend(?ajnigi)
finlandesa	Finnish, Finnishwoman(finnino)
finlandés	Finnish(finna); Finnish, Finnishlanguage(finnalingvo); Finn(finno)
fino	dainty, delicate, fine, refined(delikata); gaunt, lean, slender, thin(maldika)
finés	Finnish(finna); Finnish, Finnishlanguage(finnalingvo); Finn(finno)
firma	company, firm(firmao); signature(subskribo)
firmar	sign(subskribi)
fisonomía	face(viza?o)
flamenco	Flemmish(flandra); Flemming(flandro)
flan	cream(krema?o)
flauta	flute(fluto)
flecha	arrow(sago)
flema	mucus, phlegm(muko)
flor	bloom, flower(floro)
florin	guilder, gulden(guldeno)
foca	seal, sea?dog(foko)
folleto	leaflet, pamphlet, paperback(bro?uro)
fondear	anchor(ankrumi)
fondo	background(fono); background(malanta?plano)
formulario	blank, form(formularo)
forrar	cover, overlay(tegi)
forro	lining(sub?tofo)
forta leza	fortress(fortreso)
forzar	compel, force(devigi)
foto	photograph(foto); photograph(fotografa?o)
fotografía	photograph(foto); photograph(fotografa?o)
fotógrafo	photographer(fotisto); photographer(fotografisto)
frambuesa	raspberry(frambo)
francesa	Frenchwoman(francino)
francés	French(franca); French, Frenchlanguage(francalingvo); Frenchman(franco)
franela	flannel(flanelo)
franqueo	postage(afranko)
frase	sentence(frazo)
fregadero	dresser(kuirejstablo)
fregar	washup(lavpurigilaman?ilaron)
freir	fry(friti)
freno	brake(bremso)
freno de emergencia	communication?cord(alarmbremso)
frente	forehead(frunto)
fresa	strawberry(frago)
fresco	fresh, recent(fre?a); cool(malvarmeta)
fresno	ash(frakseno)
friolera	trifle(bagatelo)
frisio	Frisian(frisa); Frisian(frizona); Frisian(frizono)
frisona	Frisian, Frisianwoman(frizonino)
frisón	Frisian(frisa); Frisian(frizona); Frisian(frizono)
frontera	boundary, frontier, limit(limo)
frontón	façade(fasado); front, battlefront, frontage(fronto)
frotar	rub(froti)
fruta	fruit(frukto)
frutal	fruit?tree(fruktarbo)
frío	bleak, chilly, cold(malvarma); bleak, chilly, cold(malvarma¹); bleak, chilly, cold(malvarma²)
fuego	fire(fajro)
fuente	fountain(fontano); fountain, source, spring(fonto); basin, bowl, pelvis(pelvo)
fuera	abroad, out, outside(ekstere)
fuera de	outside, outsideof(ekster)
fuerte	strong(forta); firm, robust, sturdy(fortika); firm, solid(solida)
fuerza	force, strength, vigour(forto)
fuerza de caballos	horsepower(?evalforto); horsepower(?evalpovo)
fulminante	acute(akuta)
fumar	smoke(fumi)
funcionar	function, operate, run, work(funkcii)
funcionario	officer, official(oficisto)
función	function, job, office, post(ofico)
fundar	base(bazi); erect, establish, found(fondi)
furgón	luggage?van(pakvagono)
fusilar	shootdead(mortpafi)
fábrica	factory(fabrikejo); factory(fabriko)
fácil	easy, facile(facila)
fácilmente	easily(facile)
fécula	potatoflour(terpomafaruno)
fécula de patata	potatoflour(terpomafaruno)
fértil	fertile(fekunda)
física	physics(fiziko)
fósforo	match(alumeto)
gafas	glasses, spectacles(okulvitroj)
gafas oscuras	sun?glasses(sunvitroj)
gallego	Galician(galica)
galleta	biscuit, cookie(biskvito)
gallina	chicken, fowl(kokino)
gallo	cock, rooster(virkoko)
ganado	livestock(brutaro)
ganancia	accession, acquisition, gain(akira?o); accession, acquisition, asset(akiro)
ganar	earn, gain, win(gajni)
gancho	hook(hoko)
ganso	goose(ansero)
garaje	garage(gara?o)
garantía	guarantee, warrant(garantio)
garganta	throat(gor?o)
garra	claw(ungego)
garrafa	carafe, decanter(karafo)
gas	gas(gaso)
gasolina	gasolene, gasoline, petrol(benzino)
gastado	worn(eluzita)
gastar	pay out, spend(elspezi)
gastos	charge, cost, expense(kostoj)
gas natural	naturalgas(tergaso)
gata	femalecat(katino)
gato	cat(kato); jack(kriko)
gaviota	seagull(mevo)
gemelos	twins(dunaskitoj); twin(?emelo)
gemir	groan, moan(?emi)
general	general, usual(?enerala)
generalmente	generally(?enerale)
gente	people(homoj)
geografía	geographic, geographical(geografia); geography(geografio)
gerente	manager(administranto); administrator(administristo); manager(direktanto)
geógrafo	geographer(geografiisto); geographer(geografo)
ginebra	gin(?ino)
girar	turn(turni?i); endorse(?iri)
giro postal	moneyorder(po?tmandato)
globo terráqueo	globe, worldglobe(terglobo)
gobernar	control, govern, restrain, rule(regi)
gobierno	administration, government(registaro)
godo	Goth(goto)
golondrina	swallow(hirundo)
golpe	blow(bato)
golpear	beat, hit, strike(bati)
goma	rubber(ka??uko); rubber(skrapgumo)
gordo	fat, fatty, greasy(grasa)
gorrión	sparrow(pasero)
gorro	cap(kaskedo); cap(?apo)
gota	arthritis(artrito); drip, drop(guto); gout(podagro)
grabado	image, picture(bildo)
gracia	charm(?armo)
gracias	gratitude, thanks(danko); thank you, thanks(dankon)
gracioso	affable, friendly, good?natured, kind(afabla)
grado	degree, grade(grado)
gram	gram, gramme(gramo)
gramática	grammar(gramatiko)
grande	big, great, large(granda)
granero	barn, shed, stand(budo)
granito	granite(granito)
granizo	hail(hajlo)
granja	estate, farm, property, ranch(bieno)
grasa	fat, grease(graso)
gratitud	gratitude(dankemo)
gratuito	free(senpaga)
grave	important, serious(grava); court, yard, courtyard(korto); alarming, grave, serious(maltrankviliga)
greda	chalk(kreto)
grieco	Greek(greko)
griega	Greekwoman(grekino)
griego	Greek(greka); Greek(heleno)
grieta	crack, crevice(fendo); burst, crack, flaw(kreva?o)
grifo	faucet, tap(krano)
gripe	flu, grip, influenza(gripo)
gris	grey(griza)
gritar	cry out, scream, shout(krii)
grito	cry, shout(krio)
grosella	gooseberry(groso); currant(ribo); currant, redcurrant(ru?aribo)
grosero	rude(mal?entila)
grueso	bold, corpulent, fat, thick(dika); fat, fatty, greasy(grasa)
grupo	bevy, collection, group, heap, herd, set(aro¹); group(grupo)
guadaña	scythe(fal?ilo)
guante	glove, mitten(ganto)
guardabarros	mudguard(kot?irmilo)
guardar	guard, preserve, protect, save(anta?gardi); conserve, keep, maintain, preserve(konservi); protect(protekti); shelter, protect(?irmi)
guardarropa	cloakroom(vestejo)
guardavía	signalman(bariergardisto)
guardia	guard(gardo); policeman(policano); policeman(policisto)
guardiamarina	middy, midshipsman, navalcadet(mid?ipmano)
guerra	war(milito)
guiar	conduct, direct, guide, head, lead(gvidi)
guisante	pea(pizo)
gusano	worm(vermo)
gustar	please(pla?i); appreciate, like(?ati)
gusto	taste(gusto)
guía	leader(gvidanto); guide(gvidisto); handbook, guide, guidebook(gvidlibro)
gámba	prawn(salikoko)
gótico	Gothic(gotika)
haba	bean(fabo)
haber	credit(kredito)
habilidad	ability(kapableco)
habitación	chamber, room(?ambro)
habitante	inhabitant(enlo?anto); inhabitant(lo?anto)
habitar	dwell, live(lo?i)
habituarse	accustom oneself, getused(kutimi?i)
hablar	speak, talk(paroli)
hacer	achieve, act, do, make, perform(fari); accomplish, achieve, keep, observe, perform(plenumi)
hacerse	become, come about, grow, happen(fari?i); become, get, grow(i?i)
hacer dimisión	quit, resign(eksi?i)
hacer incribir	register(enskribigi)
hacer las compras	shop(butikumi)
hacer la manicura	manicure(manikuri)
hacer uso de	employ, use, makeuseof(uzi)
hace ...	...ago(anta?...)
hace poco	just, justnow(?us)
hacha	axe(hakilo)
hacia atrás	backward, backwards(malanta?en)
halcón	falcon(falko)
hallar	come across, encounter, meet, see(renkonti); find(trovi)
hallarse	be found, be located, findoneself(trovi?i); be found, be located, findoneself(trovisin)
hambre	fame, hearsay, renown, repute, rumor, rumour(famo); hunger(malsato)
harina	flour(bakfaruno); flour, meal(faruno)
hasta la vista	bye, goodbye, solong(?isrevido)
hasta luego	bye, goodbye, solong(?isrevido)
hasta que	until, till(?is)
hay	there is, thereare(estas)
haya	beech(fago)
haz el favor	please(bonvolu)
haz favor	please(bonvolu)
hebilla	buckle(buko)
hebraico	Hebrew, Jewish(hebrea); Hebrew, Jew(hebreo)
hebreo	Hebrew, Jewish(hebrea); Hebrew, Jew(hebreo); Israelite(israelido)
hecho	fact(fakto)
hectolitro	hectolitre(hektolitro)
helada	freezing cold, frost(frosto); frost(gelo)
hemorroides	haemorhoids(hemoroidoj)
hendedura	crack, crevice(fendo); burst, crack, flaw(kreva?o)
henderse	burst, split(fendi?i); burst(krevi)
hendidura	ravine(ravino)
heno	hay(fojno)
heredar	inherit(heredi)
herida	injury, wound(vundo)
herido	injured, wounded(vundita)
herir	hurt, wound(vundi)
hermana	sister(fratino)
hermano	brother(frato)
hermanos	brothers and sisters, siblings(gefratoj)
hermoso	lovely(belega)
herramienta	agent, means, tool(ilo)
hervir	boil(boli)
hiedra	ivy(hedero)
hielo	ice(glacio)
hiena	hyaena(hieno)
hierba	grass(herbo¹)
hierro	iron(fero)
higo	fig(figo)
higuera	fig?tree(figarbo); fig?tree(figujo)
hija	daughter(filino)
hijo	son(filo)
hilo	thread(fadeno)
hinchable	airbed, airmattress(pne?matikamatraco)
hindú	Hindu(hinduo)
hipopótamo	hippo, hippopotamus(hipopotamo)
historia	story, history(historio)
hoja	leaf, sheet(folio); blank, form(formularo)
hojalata	sheet metal, tin, tinplate(lado)
hoja de afeitar	razor?blade(razklingo)
holandés	Dutch(holanda); Dutchman, Hollander(holandano); Dutch(nederlanda); Dutchman(nederlandano)
holgazán	lazy(maldiligenta)
hombre	man, humanbeing(homo); fellow, man(viro)
hombre de ciencia	scientist(sciencisto)
hombre político	politician(politikisto)
hombro	shoulder(?ultro)
homenaje	honor, honour(honoro)
hongo	mushroom(?ampinjono)
honor	honor, honour(honoro)
honorable	respectable(estiminda)
honrado	above?board, honest(honesta)
hora	hour, o'clock, time(horo)
horario	schedule, time?table(horaro)
horizonte	horizon(horizonto)
hormiga	ant, emmet(formiko)
hormigón	concrete(betono)
hornada	bakedgoods(baka?o)
horrible	abhorrent, abominable, alien, awful, hideous, horrible, gruesome(abomeninda); bleak, dismal, dreary, horrible, ghastly, grisly, nasty(malagrabla); dismal, dreary, horrible, nasty(malbelega); agonizing, hideous, horrible, ghastly(terurega)
horror	abhorrence, abomination, horror(abomeno); abhorrence, horror(terurego)
horroroso	abhorrent, abominable, alien, awful, hideous, horrible, gruesome(abomeninda); dismal, dreary, horrible, nasty(malbelega); agonizing, hideous, horrible, ghastly(terurega)
hospital	hospital(malsanulejo)
hospitalidad	hospitality(gastamo)
hotel	hotel(hotelo)
hoy	today(hodia?)
hoy día	currently, nowadays, thesedays(nuntempe)
hueco	fantastic, offantasy(fantazia); frivolous(frivola); concave, hollow(kava); cavity(kava?o); hollow(kaverna); cave, cavity(kavo); airy?fairy(malserioza); conceited, frivolous, vain(vanta); chimerical(?imera)
huelga	strike(striko)
hueso	bone(osto)
huevas	spawn(frajo)
huevo	egg(ovo)
huevo frito	boiledegg(frititaovo)
huir	flee, runaway(fu?i)
humear	smoke(fumi)
humedo	damp, humid, moist(humida); moist(malseketa)
humillante	humiliating(humiliga)
hurtar	rob(pri?teli)
huésped	guest(gasto)
hábil	experienced, expert, skilful, skilled, skillful, practised(ekzercita); able, capable(kapabla); adroit, clever, dexterous, skillful(lerta)
hígado	liver(hepato)
húngara	Hungarian, Hungarianwoman(hungarino)
húngaro	Hungarian(hungara); Hungarian(hungaro)
ibérico	Iberian(ibera)
idea	idea(ideo); concept, idea(koncepto)
ideal	ideal(ideala)
idem	equally, likewise(same)
identificar	identify(identigi)
idolatría	idolatry, idolworship(idolkulto); idolatry, idolworship(idolservo)
iglesia	church, church?building, house of worship, placeofworship(pre?ejo)
ignición	ignition(sparkado)
igual	equal, even, level(egala)
igualdad	draw, equality(egaleco)
iguana	iguana(igvano)
imagen	image, picture(bildo)
imitación	imitation(imita?o)
imitar	imitate(imiti)
impedimento	handicap, impediment, obstacle(malhelpa?o)
impedir	bar, inhibit, prevent(malebligi); bar, hinder, inhibit, prevent(malhelpi)
imperdible	safety?pin, safetypin(fibolo)
imperio	empire(imperio)
implorar	implore, invoke(elpetigi)
imponer	tax(imposti)
importancia	concern(graveco)
importante	important, serious(grava)
importar	amountto(sumi?ije)
importe	amount, sum(sumo)
imposible	impossible(neebla)
impresión	trace, track(spuro)
imprimir	print(presi)
impuesto	tax(imposto)
imán	magnet(magneto)
incendio	conflagration, fire(incendio)
incitar	encourage, impel, instigate, spur on, stimulate, urge(instigi); cheer, fire, inspire, stimulate(plifervorigi); fan, fire, inspire, stimulate, stir up, urgeon(plivigligi); rouse, stimulate, stirup(stimuli)
inclemente	severe, strict(severa)
inclinado	oblique, slanting(oblikva)
incluído	including, inclusively(inkluzive)
incomodar	bother, disturb, hinder, trouble(?eni)
inconveniente	difficulty, trouble(malfacila?o)
incremento	accretion, growth(kresko)
increíble	incredible(nekredebla)
incrustación	fur, scale(alkrusti?o)
indeciso	indecisive(?anceli?ema)
indemnizar	compensate(kompensi)
indicación	index(indico); indication(indiko)
indicar	indicate, suggest(indiki); indicate, point out, show(montri)
indicio	index(indico); indication(indiko)
indico	Indian(hinda)
indigencia	misery(mizero); destitution, distress, indigence, need, penury(senhaveco)
indigente	miserable, poor(malri?a); miserable, needy(senhava)
indio	Indian(hinda); Indian(hindo); Indian, RedIndian(indiana)
indio americano	Indian, AmericanIndian(indiano)
indispuesta	not well, upset(malsaneta)
individuo	individual(individuo)
indole	character, nature, personality(karaktero)
indonesio	Indonesian(indonezia)
indonésico	Indonesian(indonezia)
indulgencia	indulgence(indulgenco)
indígena	aboriginal, domestic(enlanda); aboriginal, native(indi?ena)
infamar	slander(kalumnii)
infección	infection(infekto)
infectar	infect(infekti)
infeliz	unhappy(malfeli?a)
inferior	inferior(malsupera)
inficionar	infect(infekti); communicate(konta?i)
inflamación	inflammation(inflamo)
inflar	inflate(?veligi)
influir en	act, affect, influence(influi)
información	account, information(informo)
informar	acquaint, inform, report(informi); communicate, report(komuniki); acquaint, let know, inform(sciigi)
ingeniero	engineer(in?eniero)
ingenuo	guileless, inoffensive(senmalica)
inglesa	English, Englishwoman(anglino)
inglés	English(angla); English, Englishlanguage(anglalingvo); Englishman, Sassenach(anglo)
ingrediente	component, element, ingredient, part(ingredienco)
iniciador	pioneer(pioniro)
inicial	initial(komenca)
injuria	abuse, insult(insulto); abuse(ofendo)
injuriar	abuse, insult, offend(insulti); jeer, jeer at, taunt(mokinsulti)
inmediatamente	at once, immediately, just, right away, rightnow(tuj)
inmóvil	motionless(senmova)
innato	congenital, inborn, inbred, innate, native(denaska); congentital, inborn, inbred, innate, native(kunnaskita)
innovador	pioneer(pionira)
inocente	guiltless, innocent(senkulpa)
inpulsar	encourage, impel, instigate, spur on, stimulate, urge(instigi)
inquieto	agitated, anxious(maltrankvila)
inscribir	enter(enskribi); record, register(registri)
insecto	bug, insect(insekto)
insectos dañinos	vermin(fiinsektoj)
insistencia	insistence, pressure, urgency(insistado); insistence, pressure, urgency(insisto)
insistir	insist(insisti)
insolente	rude(mal?entila)
inspector	checker, controller(kontrolisto)
instancia	insistence, pressure, urgency(insistado); insistence, pressure, urgency(insisto)
instar	insist(insisti)
instigador	firebrand, instigator(incitanto)
instigar	abet, excite, incite, provoke, rouse, stimulate, stirup(inciti); initiate, start(iniciati); activate, cause, giveriseto(ka?zi)
instinto	access, impetus, impulse(impulso); instinct(instinkto)
instruir	teach(instrui)
instrumento	agent, means, tool(ilo)
insultar	jeer, jeer at, taunt(mokinsulti); abuse, insult, offend(ofendi)
insulto	abuse, insult(insulto)
inteligencia	notion, sense, realization(kompreno); understanding(komprenpovo)
inteligible	understandable(komprenebla)
intención	intention, meaning, plan(intenco)
intentar	attempt, test, try(provi)
interesante	interesting(interesa)
interesar	interest(interesi)
interior	inner, inside, internal(interna)
interna	inner, inside, internal(interna)
interprete	interpreter(interpretisto)
interrumpir	interrupt(interrompi)
interruptor	switch(?altilo)
interés	interest(interesi?o); interest(intereso)
intestinos	intestines(intestaro)
inventar	invent(elpensi); invent(inventi)
invierno	winter(vintro)
invitar	invite(inviti)
invocar	invoke(alpre?i); invoke(alvokipre?e)
inválido	disabled(invalida); disabledperson(invalido)
inyección	injection(injekto)
ir	go(iri)
irlandés	Irish(irlanda); Irishman(irlandano)
irregular	abnormal(abnorma); abnormal(anormala); abnormal(nenorma); abnormal(nenormala)
irse	go(iri)
ir a buscar a	takealong(kunvenigi); meet, pickup(veniporakompani)
ir por	fetch, get, pickup(irpreni)
isla	island(insulo)
islas Filipinas	Philippine Islands, Philippines(Filipinoj)
israelita	Israelite(israelido)
israelí	Israelian(israelano); Israeli(izraelano)
italiana	Italianwoman(italino)
italiano	Italian(itala); Italian, Italianlanguage(italalingvo); Italian(italo)
jabalí	wildboar(apro)
jadeante	breathless(senspira)
jamás	never(neniam)
jamón	ham(?inko)
japonesa	Japanesewoman(japanino)
japonés	Japanese(japana); Japanese, Japaneselanguage(japanalingvo); Japanese(japano)
jardinero	gardener(?ardenisto)
jardín zoológico	zoo(zoologia?ardeno)
jarra	jug, pitcher(kru?o)
jarro	jug, pot(poto); jug, box, container, vessel(ujo)
javanesa	Javanesewoman(javanino)
javanés	Javan, Javanese(java); Javanese(javano)
jefe	boss, chief, leader(estro); chief, superior(superulo); chef(?efkuiristo); chief, boss(?efo)
jengibre	ginger(zingibro)
jerez	sherry(?ereo)
jirafa	giraffe(?irafo)
joven	young(juna); youngster, youth(junulo)
joya	gem, jewel(gemo); jewel(juvelo)
joyero	jeweller(gemisto); jeweller(juvelisto)
judía	haricot(fazeolo)
judía verde	haricot(fazeolo)
judío	Israelite(israelido)
juego	game(ludo)
juego de damas	checkers(damludo)
jueves	Thursday(?a?do)
juez	judge(ju?isto)
jugar	play(ludi); play(ludi¹)
jugo	juice, sap(suko)
jugo de grosellas	currantjuice(ribsuko)
jugo de manzana	applejuice(pomsuko)
juguete	toy(ludilo)
juicio	judgment(ju?o)
julio	July(julio)
junco	cane, reed(kano)
junio	June(junio)
juntamente	together(kune); atthesametime(samtempe)
juntar	join, unite(kunigi)
juntarse	associate, come together, join, pool(kuni?i); associate, join, pool(unui?i)
jurar	blaspheme, cuss, curse, swear(blasfemi); swear(?uri)
justamente	exactly(ekzakte); exactly, sharp(precize)
juventud	youth(juneco)
juzgado	tribunal(tribunalo)
juzgar	judge(ju?i); judge(priju?i)
kilo	kilo(kilogramo)
kilómetro	kilometre(kilometro)
la	the(la)
labio	lip(lipo)
laborioso	active, hardworking(laborema)
labrador	builder(konstruisto)
laca para las uñas	nail?varnish(ungoverniso)
lado	side(flanko)
lado inferior	bottom(malsupraflanko)
ladrar	give tongue, bark(ekboji)
ladrillo	brick(briko)
ladrón	thief(?telisto)
lago	lake, loch(lago)
lago Lemán	LakeofGeneva(?enevaLago)
lamer	lick(leki)
lanchamotora	motor?boat, motor?launch(motorboato)
langosta	lobster(omaro)
lanzar	throw(?eti)
largo	long(longa)
largura	length(longeco); length(longo)
las	the(la)
lastre	ballast(balasto)
lata	can, tin, tincan(ladskatolo)
latino	Latin(latina)
latín	Latin(latino)
latón	brass(flavakupro); brass(latuno)
laurel	laurel(la?ro)
lava	lava(lafo)
lavadero	laundry(lesivejo)
lavaplatos	dishwasher(porman?ilaralavma?ino)
lavar	wash(lavi); washup(lavpurigilaman?ilaron); wash(lesivi)
lazo	bond, tie(ligilo); connection, league(ligo)
lección	lesson(leciono)
leche	milk(lakto)
lechería	dairy(lakta?fabriko)
lecho	bed(lito)
lechuga	lettuce(laktuko)
lechón	piglet(porkido)
leer	read(legi)
legúa	mile(mejlo)
lejano	distant, far, remote(malproksima)
lejos	away(for); afar, far, far away, remotely(malproksime)
lengua	tongue(lango); language, tongue(lingvo)
lenguado	sole(soleo)
lenguaje figurado	metaphor(metaforo)
lente	lens(lenso)
lenteja	lentil(lento)
lento	slow(malrapida)
letón	Latvian, Lett(latvo)
levantar	lever, lift, raise(levi)
levantarse	get up, rise, stand, standup(ekstari); get up, rise, stand, standup(stari?i)
ley	law(le?o)
león	lion(leono)
leño	timber, wood(ligno)
liar	bind, connect, join, tie, tieup(ligi)
libertino	lawless, licentious, riotous(senbrida)
libra	pound(funto); plate, sheet, slab(plato)
librero	bookseller(librovendisto)
librería	bookshop, bookstore(librobutiko)
libritode memoria	notebook(notlibro)
libro	book(libro)
libréria	bookcase(libro?ranko)
licor	liqueur(likvoro)
liebre	hare(leporo)
liebre macho	buck, buck?hare(virleporo)
ligar	bind, connect, join, tie, tieup(ligi)
ligero	light(malpeza)
lila	lilac(siringo)
lima	file(fajlilo)
lima para uñas	nail?scissors(ungotondilo)
limitado	confined, limited, restricted(limigita)
limitar	abridge, confine, limit, restrict(limigi)
limosna	alms, charity(almozo)
limpiar	polish(poluri); clean, cleanse, make clean, purge(purigi); delete, wipe, wipeoff(vi?i)
limpieza	cleanliness, purity(pureco)
limpio	clean(pura²)
limón	lemon(citrono)
lince	lynx(linko)
lindo	delightful, lovely(rava); charming, lovely(?arma)
lisera	shoulder, verge, vergeofaroad(vojbordero)
liso	even, flat, level, smooth(ebena); smooth(glata)
lista	list(listo); menu(man?okarto); menu(menuo)
lista de precios	price?list(prezlisto)
listo	finished, ready, through(preta)
litro	liter, litre(litro)
llama	flame(flamo)
llamada	appeal(apelo); parade, roll?call(kolekti?o); parade, roll?call(kunvoko)
llamar	appeal to, invoke(alvoki); hit, knock, strike(frapi); call(nomi); call, summon(voki)
llamarse	becalled(nomi?i)
llamar a la puerta	knock at the door, rapatthedoor(frapisurlapordon)
llano	plain(ebena?o); flat(plata)
llanta	felly, felloe, rim(radrondo)
llanura	plain(ebena?o)
llave	key, wrench(?losilo); adjustable wrench, spanner(?ra?b?losilo)
llave inglesa	monkey?wrench, shiftingspanner(universala?ra?bilo)
llegada	arrival(alveno)
llegar	pass, spend(pasigi)
llenar	complete(kompletigi); fill, fill in, fillup(plenigi)
lleno	complete, full(plena)
llevar	bring, fetch(alporti); bring along, takealong(kunporti); carry, wear(porti); wear(surhavi)
llorar	cry, weep(plori)
llover	rain(pluvi)
lluvia	rain(pluvo)
lo	the(la)
lobo	wolf(lupo)
loma	hill(monteto)
londinense	Londoner(londonano)
loro	parrot(papago)
los	the(la)
los dos	both(amba?)
loza	crockery, earthenware, pottery(fajenco); pottery(pota?o)
lucio	pike(ezoko)
lucir	shine(brili)
luego	soon(balda?); afterwards, next, subsequently(poste); beyond, next, then, thereafter(posttio)
lugar	inducement, occasion, motive(instigaka?zo); inducement, motive, occasion(instigaokaza?o); account, motive, reason(motivo)
lujo	luxury(lukso)
lumbar	loin(lumbo)
luna	moon(luno)
lunes	Monday(lundo)
luxemburgués	Luxemburger(luksemburgano); Luxemburg(luksemburgia); Luxemburger(luksemburgiano)
luz	light(lumo)
luz de Bengala	bengal?light, bengal?lights(bengalafajro)
luz posterior	rear?lamp, rear?light, tail?light(malanta?alampo)
luz trasera	rear?lamp, rear?light, tail?light(malanta?alampo)
lágrima	tear(larmo)
lámina	plate, sheet, slab(plato)
lámpara	lamp(lampo)
lápiz	pencil(krajono)
línea	line(linio)
líquido	liquid(likva?o)
lúgubre	bleak, dismal, dreary, horrible, ghastly, grisly, nasty(malagrabla)
macarrones	macaroni(makaronio)
maciso	massive(masiva)
madera	timber, wood(ligno)
madre	bed, watercourse(fluejo); mother(patrino)
maduro	mature, ripe(matura)
maestra	teacher, femaleteacher(instruistino)
maestro	instructor, teacher(instruisto)
magnetófono	tape?recorder(magnetofono)
magnífico	lovely(belega); bright, brilliant(brila)
majo	pretty(beleta)
malayo	Malay(malaja); Malay(malajo)
mala costumbre	habit, trick(alkutima?o)
mala suerte	badluck(malbon?anco)
malentendido	misunderstanding(miskompreno)
maleta	trunk(kofro); suitcase, valise(valizo)
maleta de mano	suitcase, valise(valizo)
malo	erroneous, mistaken, wrong(erara); bad, miserable, nasty, poor(malbona)
mal olor	stench(fetoro)
mal reputado	ofillrepute(fifama)
mancebía	brothel(bordelo)
mancha	blot, spot(makulo)
mandar	direct, guide, manage, steer(direkti); steer(stiri)
mandarina	tangerine(mandarino)
mandato	command(komando)
mando	command(komando)
mandíbula	jaw, jawbone(makzelo)
manga	sleeve(maniko)
manido	stale(malfre?a)
mano	hand(mano)
manso	tame(malsova?a)
manta	blanket(litkovrilo)
mantel	table?cloth(tablotuko)
mantequilla	butter(butero); blueberry(mirtelo)
manzana	apple(pomo)
manzano	apple?tree(pomujo)
mapa	map(geografiakarto); map(mapo)
maquinar	initiate, start(iniciati); activate, cause, giveriseto(ka?zi)
mar	sea(maro)
marcar	dial(diski)
marea	tide(tajdo)
mareado	dizzy(kapturna)
mareado en avión	airsick(aermalsana)
marfil	ivory(eburo)
margarina	margarine(margarino)
marido	husband(edzo)
marina	navy(mararmeo)
marinero	sailor(maristo)
mariposa	butterfly(papilio)
marroquí	Moroccan(maroka); Moroccan(marokano)
marroquía	Moroccanwoman(marokanino)
marroquín	Moroccan(maroka); Moroccan(marokano)
marroquína	Moroccanwoman(marokanino)
marrón	brown(bruna)
martes	Tuesday(mardo)
martes de carnestolendas	Shrove?Tuesday(Anta?fastaMardo)
martillo	hammer(martelo)
marzo	March(marto)
mar Báltico	BalticSea(BaltaMaro)
mar Rojo	RedSea(Ru?aMaro)
mar del Norte	NorthSea(NordaMaro)
mas	but(sed)
masa	lump, mass(maso); dough, paste(pasto)
masaje	massage(masa?o)
masajear	massage(masa?i)
masculino	male(maskla); male(virseksa)
masticar	chew(ma?i)
matar	butcher, slaughter(bu?i); kill, liquidate, slay(mortigi)
materia	matter(materio)
material	data, material(materialo)
matrimonio	marriage, matrimony(edzeco); marriage(edzineco); marriage(geedzeco)
matrícula	numberplate(numerplato)
mayo	May(majo)
mayoría	majority(plimulto)
maíz	corn, Indian corn, maize, mealies(maizo)
mañana	morning(mateno); tomorrow(morga?)
mañana pasado	thedayaftertomorrow(postmorga?)
mañana por la mañana	tomorrowmorning(morga?matene)
mañana por la tarde	tomorrowevening(morga?vespere)
mear	urinate(pisi); urinate(urini)
mecanógrafa	stenotypist, femalestenotypist(stenotajpistino)
mechero	lighter(fajrilo)
mecánico	mechanic(mekanikisto); mechanic(me?anikisto); chauffeur, driver(?oforo)
media	stocking(?trumpo)
media noche	midnight(noktmezo)
medicamento	drug, medicine, pharmaceutical(kuracilo)
medicina	drug, medicine, pharmaceutical(kuracilo)
medida	measure, measurement(mezuro)
medio	half(duona); half(duono); agent, means, tool(ilo); average, mean, middle(mezo); means, remedy, resources(rimedo)
mediodía	midday, noon(tagmezo)
medir	measure(mezuri)
medroso	afraid(malkura?a); afraid(tima); afraid, fearful(timigita)
medusa	jelly?fish(meduzo)
mejicana	Mexicanwoman(meksikianino)
mejicano	Mexican(meksikiano)
mejikano	Mexican(meksikia)
mejilla	cheek(vango)
mejor	better(plibona)
melindroso	prudish(pruda)
melocotón	peach(persiko)
melón	melon(melono)
mencionar	cite, quote(citi); mention(mencii)
mendicidad	begging(almozpetado)
mendigar	beg(almozpeti)
mendigo	beggar(almozulo)
menesteroso	abject, dismal, meager, miserable, wretched(mizera); miserable, needy(senhava)
menguar	abate, decrease, diminish, drop, fall(malplii?i)
menos	apart from, but, except, otherthan(escepte); fewer, less(malpli)
menos y menos	lessandless(malplikajmalpli)
mensaje	errand, message(mesa?o)
mensualmente	monthly(?iumonate)
menta	mint(mento)
mentir	lie, tellalie(mensogi)
mentira	lie(mensogo)
menú	menu(man?okarto); menu(menuo)
mercado	fair, market(foiro); market, salesactivity(merkato); market, marketplace(vendoplaco)
mercado de consumo	market, salesactivity(merkato)
merecer	be worthy of, deserve, merit(meriti)
merluza	haddock(eglefino)
mermelada	jam, marmelade(marmelado)
mermelada de manzanas	apple?sauce(pomka?o); apple?sauce(pomkompoto)
mes	month(monato)
mesa	table(tablo)
metal	metal(metalo)
meter	lay down, place, put, putdown(meti)
meticuloso	accurate, scrupulous(skrupula)
metro	metre(metro); subway, underground(metroo)
mezcla	admixture, mixture(miksa?o)
mezquino	petty, small?minded(etspirita)
mezquita	mosque(moskeo)
mi	my(mia)
miedo	agony, anguish, fear(angoro); afraid(malkura?a); afraid(tima); fright(timego); afraid, timid(timema)
miedoso	afraid(malkura?a); afraid(tima)
miel	honey(mielo)
miembro	limb, member(membro)
mil	thousand, onethousand(mil)
millón	million(miliono)
milímetro	millimetre(milimetro)
mimar	spoil(trodorloti)
mimoso	affectionate, caressing, cuddlesome, cuddly(karesema)
mineral	mineral(mineralo)
ministerio	ministry(ministrejo)
minuto	minute(minuto)
miope	near?sighted, short?sighted(miopa)
mirada	look(rigardo)
mirlo	blackbird(merlo)
misa	mass(meso)
miserable	miserable, poor(malri?a); abject, dismal, meager, miserable, wretched(mizera)
misericordia	charity, mercifulness, mercy(kompatemo)
misericordioso	charitable, merciful(kompatema)
mismo	even(e?)
mito	myth(mito)
mitología	mythology(mitologio)
mitra	miter, mitre(mitro)
miércoles	Wednesday(merkredo)
mobilario	furniture(meblaro)
mochila	backpack, knapsack(tornistro)
moda	fashion, mode(modo)
moderno	modern(moderna)
modesto	modest(modesta)
modista	milliner(modistino)
modo subjuntivo	subjunctive(subjunktivo)
mofarse de	laughat(mokridipri)
mohoso	mouldy(?ima)
mojado	wet(malseka)
moler	grind, pulverize(mueli)
molestar	bother, disturb, hinder, trouble(?eni)
molestia	hindrance(malhelpo); disquiet, disturbance, interference, unrest(perturbo); trouble(?eno)
momentito	instant, moment(momento)
momento	instant, moment(momento)
mondar habas	string(senfadenigi)
moneda	coin(monero)
monedas	change(moneretamono)
monje	monk(mona?o)
mono	ape, monkey(simio); overalls(supertuto)
monopolio	monopoly(monopolo)
monstruo	colossus(koloso)
montar	go in, enter, perform(eniri)
montaña	mountain(monto)
monte	mountain(monto)
monumental	monumental(monumenta)
monólogo	monologue, soliloquy(monologo)
morado	violet(violkolora)
morar	dwell, live(lo?i)
morder	bite(mordi)
mordisco	bite(mordo)
moreno	brown(bruna)
morera	mulberry?tree(morusujo)
morir	die, expire, passaway(morti)
mosaico	mosaic, mosaicwork(mozaiko)
mosca	fly, housefly(mu?o)
mosquito	mosquito(moskito)
mostaza	mustard(mustardo)
mostrador	counter(vendotablo)
mostrar	indicate, point out, show(montri)
motel	motel(motelo)
motivo	inducement, occasion, motive(instigaka?zo); inducement, motive, occasion(instigaokaza?o); account, motive, reason(motivo)
moto	motorcycle(motorciklo)
motocicleta	moped(mopedo)
motor	engine, motor(motoro)
moverse	move(movi?i)
mozo	porter(portisto)
muchacha	girl, lass, wench(knabino)
muchacho	boy, lad, laddie(knabo)
muchacho travieso	naughty boy, pickle(buba?o)
mucho	a lot of, much(multa); a lot of, much, plentyof(multeda)
mudar	alter, change(alii?i); change, turn(?an?i)
mudo	dumb, mute, speechless(muta)
mueblaje	furniture(meblaro)
muelle	spring(risorto)
muerte	death(morto)
muerto	dead(mortinta)
mujer	wife(edzino); woman(virino)
mulo	mule(mulo)
multa	fine(monpuno); minutes, protocol(protokolo)
multar	fine(monpuni); give a ticket, takesomebody'sname(protokoli)
multiplicar	multiply(multipliki); duplicate, multiply(multobligi)
mundo	world(mondo)
municipio	community(komunumo)
museo	museum(muzeo)
muslo	thigh(femuro)
muy	quite, very, verymuch(tre)
muérdago	mistletoe(visko)
muñeca	wrist(manradiko); wrist(pojno); doll, puppet(pupo)
máquina	engine, machine(ma?ino)
máquina de escribir	typewriter(skribma?ino)
mármol	marble(marmoro)
más	more(pli)
mástil	mast(masto)
más adelante	afterwards, next, subsequently(poste)
más bien	preferably(plivolonte); preferably, rather(prefere)
más y más	increasingly, moreandmore(plikajpli)
máximo	maximum(maksimuma)
máximum	maximum(maksimumo)
médico	doctor, physician(kuracisto)
método	method(metodo)
músculo	muscle(muskolo)
música	music(muziko)
músico	musician(muzikisto)
nabo	turnip(napo)
nacer	arise, beborn(naski?i)
nacimiento	birth(naski?o)
nacional	national(nacia)
nacionalidad	nationality(nacieco)
nada	nothing(nenio)
nadar	float, swim(na?i)
nadie	neither, nobody, none, no?one(neniu)
naranja	orange(oran?o)
naranjo	orange?tree(oran?arbo); orange?tree(oran?ujo)
nariz	nose(nazo)
nata batida	whippedcream(batitakremo)
natural	coming(devena)
naturaleza	character, nature, personality(karaktero); nature(naturo¹); character, nature(naturo²)
naturalmente	naturally(nature)
navegar	navigate(navigi)
necesario	necessary(necesa)
necesidad	need, want(bezono); necessity(neceseco)
necesitado	abject, dismal, meager, miserable, wretched(mizera); miserable, needy(senhava)
necesitar	need, require(bezoni)
neerlandesa	Dutchwoman(nederlandanino)
neerlandés	Dutch(nederlanda); Dutchman(nederlandano); Dutch, Dutchlanguage(nederlandalingvo)
negar	deny(nei)
negativa	refusal(rifuzo)
negativo	negative(negativa)
negocio	enterprise(entrepreno)
negro	Negro(negro); black(nigra)
nene	baby(bebo)
nervio	nerve(nervo)
neumático	tyre(pne?matiko); tire, tyre(pne?mo); cover, outercover(radringo)
nevado	snowy(ne?kovrita)
nevar	snow(ne?i)
niebla	fog, mist(nebulo)
nieto	grandson(nepo)
nieve	snow(ne?o)
nilón	nylon(nilono)
ninguno	neither, nobody, none, no?one(neniu)
nivel	level(nivelo)
ni mucho menos	notatall(tutene)
niño	bairn, child, infant(infano¹); child(infano²)
no	no(ne¹); not(ne²)
noble	ofnoblebirth(nobela)
nobleza	nobility(nobelaro)
noche	night(nokto); evening(vespero)
noción	concept, idea(koncepto)
nogal	walnut?tree(juglandarbo); walnut?tree(juglandujo)
nombramiento	appointment, appointmenttooffice(enoficigo)
nombrar	appoint(enoficigi)
nombre	appellation, name(nomo)
nombre de pila	firstname(anta?anomo)
normal	normal(norma); normal(normala)
norte	north, North(nordo)
noruega	Norwegianwoman(norvegino)
noruego	Norwegian(norvega); Norwegian(norvego)
nosotras	us, we(ni)
nosotros	us, we(ni)
nostalgia	nostalgia(nostalgio)
notable	considerable, sizable(konsiderinda)
notar	note, make a note, writedown(noti)
notario	notary(notario)
noticia	account, communication(komuniko); advice, announcement, communication, message, notice, report(sciigo)
noticias	news, novelty, somethingnew(nova?o); advice, announcement, communication, message, notice, report(sciigo)
notificar	instruct, notify, summon(ordoniskribe)
notoriedad	acquaintance, conversance, familiarity(konateco)
notorio	well?known(konata)
novela	novel(romano¹)
noviembre	November(novembro)
novio	beloved, loved one, lover, sweetheart, well?beloved(amato)
no ... del todo	notatall(tutene)
no ... mas	nolonger(neplu)
no ... mas que	exclusively, just, only(nur)
no ... nunca	never(neniam)
no tener razón	bewrong(malpravi)
no tocar	keepone'shandsoff(netu?i)
nube	cloud(nubo)
nudo	knot, node(nodo)
nueve	nine(na?)
nuevo	new, novel(nova)
nuez	nut(nukso)
nuez moscada	nutmeg(muskato)
nunca	never(neniam)
níquel	nickel(nikelo)
número	amount, number(nombro); number, numeral(numero)
o	or(a?)
oasis	oasis(oazo)
obedecer	obey(obei)
obispo	bishop(episkopo)
objeción	objection(kontra?argumento)
objecto	article, object, thing(objekto)
objeto	thing(a?o); aim, goal, purpose, target(celo)
obligar	compel, force(devigi)
obligatorio	compulsory(deviga)
obra	work(verko)
obrera	female laborer, femal labourer, femalworker(laboristino)
obrero	hand, laborer, labourer, operative, worker, working man, workman(laboristo)
observar	keep, mind, observe(observi)
obstrucción	dam(bara?o); barrier, fence(barilo); bar, barrier(baro)
obtener	achieve, acquire, attain, get, obtain(akiri); get, have, receive(ricevi)
obtuso	blunt(malakra); dull, obtuse(obtuza)
oca	goose(ansero)
ocasionar	activate, cause, giveriseto(ka?zi); cause, causetotakeplace(okazigi)
occipucio	back of the head, occiput(okcipito)
ochenta	eighty(okdek)
ocho	eight(ok)
ochocientos	eighthundred(okcent)
octavo	eighth(oka)
octubre	October(oktobro)
oculista	oculist, ophtalmologist(okulisto)
ocultar	conceal, hide(ka?i)
ocultarse	hide, hideoneself(ka?isin)
oculto	hidden(ka?ita)
ocupado	busy(okupita)
ocupar	occupy, take(okupi)
océano	ocean(oceano)
odiar	hate(malami)
odio	hate(malamo)
oeste	west, West(okcidento); west(uesto)
ofender	abuse, insult, offend(ofendi)
ofensa	abuse, insult(insulto); abuse(ofendo)
oferta	offer(oferto); presentation(prezentado); presentation(prezento)
oficial	official(ofica); official(oficiala)
oficina	bureau, office(oficejo)
oficina de correos	postoffice(po?toficejo)
oficina de informaciones	inquiry?office(informejo)
oficio	handicraft, occupation, trade(metio); function, job, office, post(ofico)
oficioso	accommodating, helpful(helpema)
ofrecer	bid, offer, makeanofferof(oferti)
ofrecimiento	offer(oferto); presentation(prezentado); presentation(prezento)
ojo	eye(okulo)
ola	wave(ondo)
oleaje	billow(ondego)
oler	give off an odour, reek, smell(odori)
oler a	smellof(odorikiel)
oler mal	reek, smell, smell bad, stink(fetori)
olivo	olive?tree(olivujo)
olla	jug, pot(poto); jug, box, container, vessel(ujo)
olmo	elm(ulmo)
olor	aroma, flavour(aromo); odor, odour, scent, smell(odoro)
olvidar	forget(forgesi)
omnipotencia	omnipotence(?iopovo)
omnipotente	almighty, all?powerful, omnipotent(?iopova)
omnisciente	all?knowing, omniscient(?ioscia)
once	eleven(dekunu)
opinión	opinion(opinio)
opio	opium(opio)
oponerse	confront, stand up to, withstand(kontra?stari); resist, withstand(rezisti)
oprimido	stale(malfre?a); airless, oppressive, stiffling, sultry(sufoka)
oprimir	suppress(subpremi)
oración	appeal, entreaty, supplication(petego)
orden	order(sinsekvo); warrant, writ(skribaordono)
ordenador	computer(komputero)
orden del día	agenda(tagordo)
orden por escrito	warrant, writ(skribaordono)
oreja	ear(orelo)
orgulloso	proud(fiera)
origen	lineage(deveno); beginning, commencement, start(komenci?o); origin(origino)
original	aboriginal, original(origina); original(originala)
originario	coming(devena)
orina	urine(urino)
orinal	pot, chamberpot(noktovazo)
orinar	urinate(pisi); urinate(urini)
oro	gold(oro)
ortiga	nettle(urtiko)
ortografía	orthography(ortografio)
oruga	caterpillar(ra?po)
osa	she?bear(ursino)
oscuro	dark, dim(malluma)
oso	bear(urso)
ostra	oyster(ostro)
otoño	autumn(a?tuno)
otra vez	afresh, again, all over again, anew(denove); afresh, again, oncemore(ree)
otro	other, another, else(alia)
otro lado	oppositeside(transaflanko)
oveja	sheep(?afo)
oír	hear(a?di)
paciencia	patience(pacienco)
padre	father(patro¹); father(patro²)
padres	parents(gepatroj)
padre y madre	parents(gepatroj)
pagar	pay(pagi)
pagar a plazos	payonaccount(pagiparte)
pago	payment(pago)
paisaje	landscape, scenery(pejza?o)
pala	shovel(?ovelilo)
palabra	word(vorto)
palacio	palace(palaco)
palmera	palm, palmtree(palmo)
palo	baton, cane, stick(bastono)
paloma	pigeon(palumbo)
pan	bread, loaf(pano)
pana	brakedown(paneo)
panadero	baker(bakisto)
panadería	bakery(bakejo)
panecillo	roll(bulko)
panne	brakedown(paneo)
pantalón	pants, trousers(pantalono)
pantalón corto	short pants, shorts(kuloto); short pants, shorts(pantaloneto)
pantorrilla	calf(suro)
papel	paper(papero)
papelería	stationer'sshop(kontorbezona?butiko)
papel de cartas	writing?paper(leterpapero)
papel higiénico	toilet?paper(necesejapapero)
papel pintado	tapestry, wallcovering(tapeto)
papel secante	blotter, blottingpaper(sorbapapero)
paquete	packet, parcel(paketo)
par	pair(duo); even(para); pair(paro)
para	for, to, in order to, per(por)
parachoques	buffer, bumper(bufro)
parada	stop(haltejo)
parada del autobús	busstop(a?tobushaltejo); bus stop, busstop(bushaltejo)
paraguas	umbrella(pluvombrelo)
paralelo	parallel(paralela)
paraninfo	auditorium(a?lo)
parar	turnaway(deturni); halt, come to a halt, stop(halti); halt, stop(haltigi); shut off, stop, switch off, turnoff(malfunkciigi)
para que	so, sothat(porke)
para una persona	oneperson(unupersona)
parche	adhesiveplaster(diakilo)
pardo	brown(bruna); grey(griza)
pardone usted	excuseme(pardonu)
parecer	appear, look(aspekti); appear, appear to be, seem(?ajni)
parecerse	be similar, resemble(simili)
pared	wall(muro)
pariente	relative, femalerelative(parencino); relative(parenco)
parir	bear, givebirthto(naski)
parisiense	Parisian(parizano)
parque	park(parko)
parra	vine, grapevine(vito)
parroquiano	client, customer(kliento)
parte	part, Parthian, share(parto); part, piece, share(parto¹); share(porcio); share(profitparto)
parte trasera	back, reverse, reverseside(malanta?aflanko)
particular	affair, business, business deal, case, matter(afero); apart, particular, separate, special(aparta)
partidario	acolyte, member, supporter(ano); member, supporter(partiano)
partido	adherents, disciples, following, party, supporters(anaro); adherents, disciples, followers, partymembers(partianoj); faction, party, side(partio); adherents, disciples, followers, following, party, supporters(sekvantaro)
pasada	former, last, previous, prior(anta?a); last(pasinta)
pasado	former(estinta); past(estinteco)
pasado mañana	thedayaftertomorrow(postmorga?)
pasaporte	passport(pasporto)
pasar	pass, spend(pasigi)
pasillo	corridor, passage(koridoro)
paso	pass(montpasejo); gate, gangway, passage, passageway(pasejo); pace, step, stride(pa?o); passage(trairejo)
paso a nivel	level?crossing(traknivelapasejo)
paso de montaña	pass(montpasejo)
pasta dentrífica	tooth?paste(dentpasto)
pasta de almendras	almondpaste(fran?ipano)
pastel	bakedgoods(baka?o); pie, tart(torto)
pastelero	confectioner(kukbakisto)
pastelería	confectionery(kukbakejo)
pastel de almendra	almoundpastry(migdalkuka?o)
pastor protestante	pastor(pastoro)
patada	kick(piedbato)
patata	potato(terpomo)
patillas	whiskers, side?whiskers(vangoharoj)
patinar	skate(glitkuri); skate(sketi)
patinete	scooter(skutilo); scooter(trotilo)
patio	court, yard, courtyard(korto)
pato	duck(anaso)
patria	cradle, placeofbirth(naski?ejo); fatherland(patrujo)
patriarca	patriarch(patriarko)
patrono	patron(patrono)
patrón	boss, chief, leader(estro); chief, boss(?efo)
pavo	turkey(meleagro)
paz	peace(paco)
país	country, land(lando)
pañal	swaddlingcloth(vindotuko)
peatón	pedestrian(piediranto)
pecho	bosom, breast, chest(brusto)
pedal	pedal(pedalo)
pedazo	bit, lump, piece(peco)
pedido	order(mendo)
pedir	book, order, reserve(mendi); ask, ask for, beg, bid, request(peti)
pedir limosna	beg(almozpeti)
pegar	sew, sewon(alkudri); thrash(bategi); glue, stick(glui)
peinar	comb(kombi)
peine	comb(kombilo)
peligro	danger, peril(dan?ero)
peligroso	dangerous(dan?era)
pelota	ball(pilko)
peludo	hairy, hirsute(harkovrita)
peluquera	hairdresser, femalehairdresser(frizistino)
peluquero	barber, hairdresser(frizisto)
pelvis	basin, bowl, pelvis(pelvo)
película	film, motion picture, movie(filmo)
pendiente	ear?drop, earring(orelpenda?o); pending(pritraktata)
pensamiento	thought(penso)
pensar	think(pensi)
pensión	boarding house, boardingschool(pensiono)
península	peninsula(duoninsulo)
pepino	gherkin(kukumeto); cucumber(kukumo)
pequeño	diminutive, little, small(malgranda)
pera	pear(piro)
peral	pear?tree(pirujo)
perca	bass(perko)
perder	miss(maltrafi); lose(perdi)
perderse	loseone'sway(vojerari)
perdida	loss(perdo)
perdido	lost(perdita)
perdiz	partridge(perdriko)
peregrinación	pilgrimage(pilgrimado)
perejil	parsley(petroselo)
perfume	perfume(parfumo)
periodista	journalist, femalejournalist(gazetistino); journalist(gazetisto); journalist, femalejournalist(?urnalistino); journalist(?urnalisto)
perito de contabilidad	accountant(kontrevizoro)
periódico	gazette, magazine, newspaper, periodical(gazeto)
perjudicar a	harm(malutili)
perla	pearl(perlo)
permiso	permission(permeso)
permitir	accord, admit, afford, allow, permit(permesi)
pero	but(sed)
perpetrar	achieve, act, do, make, perform(fari); accomplish, achieve, keep, observe, perform(plenumi)
perro	dog(hundo)
persa	Persian(persa); Persian(perso)
perseguir	chase, persecute, prosecute, pursue(persekuti)
persona	person(persono)
personal	personal(persona)
pertenecer a	belongto(aparteni); belong to, beoneof(estiunuel)
peruana	Peruvianwoman(peruanino)
peruano	Peruvian(perua); Peruvian(peruano)
perímetro	circumference(cirkonferenco); outskirts, periphery(periferio)
pesado	burdensome, heavy, onerous(peza)
pesar	weigh(pezi)
pescador	fisherman(fi?isto)
pescar	fish(fi?i)
peso	weight(pezo)
petición	request(peto)
petroleo	paraffin?oil, petroleum(petrolo)
petróleo	crudeoil(krudapetrolo); crudeoil(nafto)
petulancia	wantonness(fipetolemo); wantonness(tumultemo)
petulante	wanton(fipetola); wanton(tumultema)
pez	fish(fi?o)
pezuña	hoof(hufo)
pez de colores	goldfish(orfi?o)
pez dorado	goldfish(orfi?o)
picar	pick, stab, sting(piki)
picazón	itch(juko)
pichón	dove, pigeon(kolombo)
pico	beak, bill(beko); mountain peak, mountain top, pinnacle(montsupro); woodpecker(pego)
pic nic	picnic(pikniko)
piedra	stone(?tono)
piel	fur, hide, skin(felo); skin(ha?to); fur, fur coat, furpiece(pelto)
pierna	leg(gambo); leg, paw(kruro)
piernas torcidas hacia afuera	knock?kneed legs, turned?inlegs(ikskruroj)
pieza	fragment, lump, piece(fragmento); part, piece, share(parto¹)
pijama	pyjamas(pi?amo)
pila	battery(pilaro)
pimienta	pepper(pipro)
pimiento	paprika(papriko)
pino	pine, pine?tree(pino)
pintar	paint(pentri)
pintor	painter(pentristo)
pintoresco	picturesque(pitoreska)
pintura	dye, paint(farbo); painting, picture(pentra?o)
piojo	louse(pediko)
pipa	pipe(pipo)
pirenaico	Pyrenean(pirenea)
piscina	pool, swimming?bath, swimming?pool(na?ejo)
piso	apartment, flat(apartamento); floor, storey, story(eta?o)
piso bajo	ground?floor(tereta?o)
pistón	piston(pi?to)
piña	pineapple(ananaso)
placer	pleasure(pla?o); fun, pleasure(plezuro)
plancha	iron, flat?iron(gladilo)
planchar	iron, ironclothes(gladi)
plano	even, flat, level, smooth(ebena); map(mapo); design, diagram, plan, plane(plano)
planta	sole(plando); plant(planto)
plantar	plant(planti)
plantío	planting(plantado)
plata	silver(ar?ento)
plataforma	platform(vagoneniravestiblo)
plataforma posterior	rearplatform(malanta?aplatformo)
platija	plaice(plateso)
platillo	cymbal(cimbalo); saucer(subtaso)
plato	food(man?a?o); menu(menuo); plate(telero)
playa	beach(pla?o)
plaza	plaza, square, publicsquare(placo)
plaza de toros	bullring(ta?robatalaareno); bullring(ta?robatalejo)
pleito	complaint(plendo)
plemear	hightide(alfluo¹)
plombo	lead(plumbo)
pluma	feather(plumo¹)
plástico	plastic(plasto)
plátano	banana(banano); banana(pizango)
población	population(lo?antaro); folk, nation, people(popolo); city, town(urbo)
pobre	miserable, poor(malri?a); abject, dismal, meager, miserable, wretched(mizera); poor(povra); miserable, needy(senhava)
pobreza	poverty(malri?eco)
pobrezo	misery(mizero)
poco	a little, rather, some, somewhat, tosomeextent(iom); a little, rather(iomete); little(malmulta)
poco a poco	gradually, littlebylittle(iompostiom)
podadera	bill, pruning?knife(bran?otran?ilo)
podadera de mango largo	polepruner(bran?tondilego)
podadera de mano tipo yunque	anvilpruner(ambosabran?tondilo)
podadera de vanilla	polepruner(bran?tondilego)
poder	beableto(povi); ability(povo)
podrido	addled, bad, rotten(putra)
poesía	poetry(poezio)
polaca	Polishwoman(polino)
polaco	Polish(pola); Pole(polo)
polaina	gaiter, legging(tibiingo)
policía	police(polico)
pollo	chick, chicken(kokido)
polonesa	Polishwoman(polino)
polonés	Polish(pola); Pole(polo)
polvo	dust(polvo)
polvos	powder, cosmeticpowder(pudro); powder(pulvoro)
política	policy, politics(politiko)
político	politician(politikisto)
pomelo	grapefruit(grapfrukto)
poner	put on, start, switch on, turnon(ekfunkciigi); turnon(en?alti); lay(ku?igi); lay down, place, put, putdown(meti)
ponerse	attitudinize, pose, putonairs(afekti); puton(surmeti); dress, getdressed(vesti?i); dress(vestisin)
poner en depósito	deposit(deponi)
poner pleito a	sue(procesikontra?)
poney	pony(poneo)
popa	poop, poopdeck, stern(pobo); stern(postasteveno); poop, poopdeck, stern(po?po)
poquito	a little, rather(iomete)
por	a, in, inside, into, on, per, within(en); a, per(po?); through(tra)
porciento	percent, percentage(procento)
porque	because, forthereasonthat(protioke); because, forthereasonthat(tialke); as, because, for, since(?ar)
portamonedas	purse, wallet(monujo)
portero	porter(pordisto)
portuguesa	Portuguesewoman(portugalino)
portugués	Portuguese(portugala); Portuguese, Portugueselanguage(portugalalingvo); Portuguese(portugalo)
portátil	portable(portebla)
porvenir	future(estonteco)
por decirlo así	sotospeak(portieldiri)
por ejemplo	for example, forinstance(ekzemple)
por eso	on that account, therefore(protio); on that account, therefore(tial)
por favor	please(bonvolu)
por fin	at last, finally, ultimately(fine)
por fortuna	fortunately(bon?ance); unfortunately(feli?e)
por la derecha	right, totheright(dekstren)
por la izquierda	left, totheleft(maldekstren)
por la mañana	inthemorning(matene)
por la noche	intheevening(vespere)
por la tarde	intheevening(vespere)
por lo más	atmost(maksimume); atmost(pleje)
por lo tocante a	about, concerning(koncerne); about, concerning, on, upon(pri); as to, as regards, concerning(rilate)
por medio de	by, by means of, on, through, with(per)
por qué	what for, why(kial¹); why(kial²); what for, wherefore, why(prokio¹); what for, wherefore, why(prokio²)
por razón de oficio	officially(la?ofice)
por separado	apart, separately(aparte)
por suerte	by accident, bychance(hazarde)
poseer	own, possess(posedi)
posible	possible(ebla)
postal	picturepostcard(bildkarto); postcard(po?tkarto)
poste	pole, post, stanchion, stake(fosto)
postre	dessert(deserto)
postrero	last(lasta)
practicable	passable, practicable(irebla); passable, practicable(surirebla)
precavido	careful, cautious(singarda); careful, cautious(singardema)
precio	price(prezo)
precio de entrada	admission, admissionfee(enirpago)
precipicio	abyss, chasm, gulf, precipice(abismo)
precipitadamente	hastily, hurriedly, inahurry(haste)
preciso	accurate, precise(preciza); correct, exact, proper, right(?usta)
preferir	prefer(preferi)
pregunta	question(demando)
preguntar	ask(demandi)
preguntarse	ask oneself, wonder(demandialsi)
prejuicio	prejudice(anta?ju?o)
premiar	awardaprize(premii)
preocupar	agitate, alarm(maltrankviligi)
preparar	prepare(prepari)
presa	dam(bara?o)
presencia	presence(?eesto)
presentación	accession(ali?o); presentation(prezento)
presente	present(?eestanta)
preservativo	condom, rubber(kondomo)
presión	pressure(premo)
prestar	borrow(pruntepreni); borrow, lend, loan(prunti)
preste	priest(sacerdoto)
presumido	attitudinizer, poseur(afektulo)
presupuesto	budget, estimate, estimates(prezkonjekto)
pretensión	offer, offerofparriage(edzi?peto); offer, offer of marriage, proposal(edzi?propono); claim, presumption, pretence(pretendo)
pretina	belt, girdle(zono¹)
prever	foresee(anta?vidi)
prima	cousin(kuzino)
primavera	spring, springtime(printempo)
primeramente	first, firstly, firstofall(unue)
primero	first(unua); first, firstly, firstofall(unue)
primeros socorros	firstaid(sukurismo); firstaid(unuahelpo)
primitivo	initial(komenca)
primo	cousin(kuzo)
primo segundo	secondcousin(prakuzo)
princesa	princess(princino)
principal	mostimportant(plejgrava); main, predominant, principal(precipa); chief, main, major, principal(?efa)
principalmente	above all, especially, chiefly, mainly, principally(precipe); chiefly(?efe)
principiante	beginner(komencanto)
principiar	begin, commence, start(komenci?i)
principio	beginning, commencement, start(komenci?o); beginning, commencement, start(komenco); principle(principo)
prisa	haste(hasto); speed(rapideco); urgency(ur?eco)
prisión	jail, gaol, prison(malliberejo); jail, gaol, prison(malliberulejo); jail, gaol, prison(prizono)
privar	rob(prirabi)
probablemente	probably(ver?ajne)
probar	attempt, test, try(provi); prove(pruvi); tryon(surprovi); tryon(vestiprove)
procedente de	a native of, comingfrom(devenade)
proceso	action, lawsuit(proceso)
proceso verbal	minutes, protocol(protokolo)
proclamación	proclamation(proklamo)
proclamar	issue, proclaim(proklami)
procurarse	achieve, acquire, attain, get, obtain(akiri); buy, get, procure(havigialsi); buy, get, procure(provizisinper)
producción	making, manifacture(fabrikado); making, manufacture(farado)
producir	activate, cause, giveriseto(ka?zi); afford, bear, produce(produkti)
producto	product(produkto)
profesional	professional(profesia)
profesión	profession(profesio)
profundidad	depth(profundo)
profundo	deep, profound(profunda)
progreso	advance, advancement, progress(progreso)
prohibir	forbid, prohibit(malpermesi)
prohijar	affiliate(filiigi)
promesa	affirmation, promise(promeso)
prometer	promise(promesi)
prometida	bride, fiancée(fian?ino)
prometido	fiancé(fian?o)
promulgar	issue, proclaim(proklami)
pronombre demonstrativo	demonstrative, demonstrativepronoun(demonstrativo); demonstrative, demonstrativepronoun(montrapronomo)
pronto	soon(balda?); fast, quickly, swiftly(rapide)
pronunciación	pronunciation(prononco)
pronunciar	pronounce(elparoli); pronounce(prononci)
propiedad	ownership(proprieto)
propietario	owner(proprietulo)
propina	tip(trinkmono)
propio	own, personal(propra)
proposición	offer, tender(proponado)
propulsión	drive(propulso)
propósito	design, diagram, plan, plane(plano); plan, project, scheme(projekto)
prostituta	prostitute(prostituitino)
protección	protection(protektado)
protectar	protect(protekti)
protector	patron(protektanto)
proteger	protect(protekti)
protegido	protégé(protektato)
protesta	protest(protesto)
protestante	Protestant(protestanta)
protestar	protest(protesti)
provecho	benefit, gain, profit(gajno); gain, profit(profito); advantage, benefit(utilo)
proveniente	coming(devena)
provisionalmente	for the time being, temporarily(provizore)
proyectar	make a project of, plan(projekti)
prudente	thoughtful(anta?zorga); careful, cautious(singarda)
prueba	problem, trouble(problemo); proof, sign, token(pruvo)
prusiano	Prussian(prusa); Prussian(pruso)
prémio	premium, prize(premio)
príncipe	prince(princo)
próximo	future(estonta); close, near, nearby, next(proksima); following, next(sekvonta); next(venonta)
psiquiatra	psychiatrist(psikiatro)
publicación	advice, announcement, communication, message, notice, report(sciigo)
publicar	advertise, announce, givenotice(anonci); publish, reveal(publikigi); acquaint, let know, inform(sciigi)
pudín	pudding(pudingo)
pueblecito	hamlet, township(vila?eto)
pueblo	folk, nation, people(popolo); village(vila?o)
puente	bridge(ponto)
puerta	gate, gateway, portal(pordego); door(pordo)
puerta trasera	back?door(malanta?apordo)
puerto	harbor, harbour, port(haveno)
puesta del sol	sunset(sunsubiro)
puesto	barn, shed, stand(budo)
puesto de Primeros Auxilios	first?aidstation(sukurejo)
puesto que	because, forthereasonthat(protioke); because, forthereasonthat(tialke); as, because, for, since(?ar)
pulga	flea(pulo)
pulgar	thumb(dikfingro); thumb(polekso)
pulmón	lung(pulmo)
pulsera	bracelet(braceleto); bracelet(?irka?brako)
punta	peak, point, tip, summit(pinto)
puntiagudo	pointed, spiked(pinta)
punto	dot, period, point, spot(punkto)
punto de contacto	startingpoint(komencloko)
punto de partida	startingpoint(deirpunkto)
punto inicial	startingpoint(deirpunkto)
purgante	laxative(laksigilo)
puro	pure(pura¹)
puré de patatas	mashedpotatoes(terpomaka?o)
pus	pus(puso)
puta	hooker, whore(putino)
putrefacción	corruption, decay, depravation, taint(malboni?o); decay(putri?o)
puño	fist(pugno)
pájaro	bird(birdo)
pálido	pale, sallow(pala)
párpado	eyelid(palpebro)
párrafo	paragraph(alineo)
píldora	pill(pilolo)
póliza	policy, insurancepolicy(poliso)
que	that(ke); than(ol)
quebraja	crack, crevice(fendo); burst, crack, flaw(kreva?o)
quebrar	break(rompi)
quedar	meet(rendevui); besituated(situi)
quedarse	remain, stay, stayover(resti)
quedarse atrás	be kept in, be detained, remain, stayon(postresti)
queja	complaint(plendo)
quejarse	complain(plendi)
quemado	burnt(brulgusta)
quemar	burn(bruligi); beburntdown(forbruli); burndown(forbruligi)
quemarse	sticktothepan(brulglui?i)
queque	cake(kuko)
querer	love(ami); desire, wish(deziri)
querer decir	aim, intend(celi); mean(volidiri)
querido	beloved, loved one, lover, sweetheart, well?beloved(amato); best(plejbona)
queso	cheese(froma?o)
quieto	calm, quiet(kvieta)
quince	fifteen(dekkvin)
quinto	fifth(kvina); fifth(kvinono)
quitar	abstract, takeaway(forpreni)
quitarse	take off, putoff(demeti); absent onself, depart, go away, leave(foriri)
quitar el polvo	dust(senpolvigi)
quitar el polvo a	dust(senpolvigi)
quizás	maybe, mayhap, perchance, perhaps, possibly(eble)
química	chemistry(kemio); chemistry(?emio)
químico	chemist(kemiisto); chemist(?emiisto)
ración	share(porcio)
radiador	radiator(radiatoro)
radio	radio, wireless(radio²)
radio de acción	radius(radiuso)
ralea	property, quality(kvalito)
rama	bough, branch(bran?o)
rana	frog(rano)
raramente	seldom(malofte)
raro	rare(malofta)
rascar	scratch(grati)
rata	rat(rato)
ratón	mouse(muso)
raya	ray, strip, stripe(strio)
rayo	beam, ray(radio¹)
rayos de Röntgen	X?rays(iksradioj)
rayos x	X?rays(iksradioj)
raza	breed, race(raso)
razonable	acceptable(akceptinda)
reaccionar	react, respond(reagi)
realizar	accomplish, achieve, actout(efektivigi); produce(realigi)
realizarse	come about, happen, occur(okazi)
rebaja	abatement, discount, rebate(rabato)
rebanada	breadandbutter(buterpano)
rebuznar	bray(iai)
recado	errand, message(mesa?o)
recalar	endup(finveni)
recelo	suspicion(malfido); suspicion(suspekto)
recelocaz	suspicion(suspekto)
receloso	suspicious(malfida); suspicious(malfidema); suspicious(suspektema)
receta	prescription, recipe(recepto)
rechazar	reject(malakcepti); reject(malakceptivo?done); refuse, reject(rifuzi)
recibir	get, have, receive(ricevi)
recibo	receipt(kvitanco); acknowledgement, receipt(ricevatesto)
recientemente	recently(fre?date)
recipiente de agua	basin, reservoir(baseno)
recitar	recite(reciti)
recoger	collect, gather, pickup(kolekti); get, lay hold of, pick up, take(preni)
recoger la mesa	clear away, removethecloth(forigilaman?ilaron)
recomendable	recommendable(rekomendinda)
recomendación	recommendation(rekomendo)
recompensa	compensation, reward(rekompenco)
recompensar	compensate, reward(rekompenci)
recorrer	cover, go through, passthrough(trairi)
recreación	entertainment(amuza?o)
recuerdo	keepsake, memento, souvenir(memora?o); keepsake, memento, souvenir(memoriga?o); memory, recollection(memoro); recollection(rememoro)
red	net, network(reto)
redicho	hackneyed(gurdita); hackneyed, hard?worked, stale, trite, worn?out(tedebanala)
redondear	round, roundoff(rondigi)
redondel	arena(areno)
redondo	round(ronda)
reducción	abatement, discount, rebate(rabato)
reflexionar	think, think about, reflecton(pripensi)
reflexión	consultation, deliberation(interkonsili?o)
reflujo	lowtide(refluo)
refrenar	control, govern, restrain, rule(regi)
refugio	asylum(azilo); Alpine hut, climber's hut, mountainhut(montkabano)
regalo	gift, present(donaco); gift(dona?o)
regar	irrigate, water(akvumi); water(surver?i)
registrar	examine(ekzameni); audit, check, check up on, supervise, verify(kontroli); record, register(registri)
registro	account book, record, register(registro)
región	region(regiono)
regla	regulation, rule(regulo)
reglamento	regulations, rules(regularo)
rehusar	reject(malakcepti); refuse, reject(rifuzi)
reina	queen(re?ino)
reino	kingdom(re?lando)
reja	barrier, fence(barilo)
relación	relation, understanding(interrilato); relation(rilato)
relampaguear	lighten(fulmi)
relevar	taketheplaceof(anstata?i)
relevo	replacement, substitution(anstata?o)
religión	religion(religio)
relleno	replacement, replenishment, supplement(kompletigo)
reloj	watch(horlo?eto); clock, watch(horlo?o)
relojero	watchmaker(horlo?isto)
reloj de pulsera	watch, wrist?watch(brakhorlo?o)
relámpago	lightning(fulmo)
remar	row(remi)
remendar	mend, patch, patchup(fliki)
remitente	sender(ekspedinto); sender(sendinto)
remo	oar(remilo)
remolacha	beet(beto)
remolcar	drag, tow(treni)
remolque	trailer(postveturilo)
renegado	unfaithful(malfidela)
renunciar a	relinquish, renounce, waive(rezignipri)
reparar	fix, repair(ripari)
reparo	criticism(kritiko); observation, remark, reproof(malla?do); observation, remark(ripro?arimarko)
repeler	protect from, wardoff(?irmisinkontra?)
repetir	repeat(rediri); repeat(ripeti)
reponerse	revive(revivi?i)
reprender	reproach, rebuke, reprove, scold(malla?di); blame, rebuke, reproach, reprove, scold(ripro?i)
representante	agent(agento)
representante exclusivo	soleagent(solaagento)
representar	act for, represent(reprezenti)
reprimir	bridle, check, restrain(bridi); control, govern, restrain, rule(regi)
reprobable	blameworthy, censurable, condemnable, objectionable(malaprobinda)
reprobación	censure, condemnation, disapprobation, disapproval(malaprobo)
reprobar	condemn, disapprove, disapprove of, rebuke(malaprobi); reproach, rebuke, reprove, scold(malla?di); blame, rebuke, reproach, reprove, scold(ripro?i)
reproducción	image, picture(bildo); figure, diagram, image, picture, representation(figuro)
reproducir	depict, represent(figuri)
repugnancia	aversion, dislike(antipatio); disgust, nausea(na?zo)
repulsar	reducetheprice(rebati)
república	republic(respubliko)
requerir	admonish, scold(admoni)
resabio	habit, trick(alkutima?o)
reservar	reserve(anta?mendi); reserve(rezervi); book(rezervigi)
resfriado	cold(malvarmumo); cold(nazkataro)
resignación	acquiescence, rezignation(rezignacio)
resistir	resist, withstand(rezisti)
resolver	decide(decidi)
respaldo	prop, support(apogilo)
respectar	esteem, thinkwellof(estimi)
respecto de	about, concerning(koncerne); about, concerning, on, upon(pri); as to, as regards, concerning(rilate)
respetable	respectable(estiminda)
respetar	respect(respekti)
respiración	respiration(spirado); breath(spiro)
respirar	exhale(elspiri); breathe(spiri)
responder	answer, reply, respond(respondi)
responder a	answer(respondial)
responsabilidad	responsibility(respondeco)
responsable	accountable, responsible(responda); accountable, responsible(respondeca)
respuesta	answer, reply(respondo)
resquebrajarse	burst, split(fendi?i); burst(krevi)
restar	remain, stay, stayover(resti)
restaurante	restaurant(restoracio)
resultado	result(rezulto)
resultar	pointouttobe(montri?i)
resumen	abridgement, abstract, resumé, summery(resumo)
retaguardia	rear, rearguard(ariergardo); defence, rear, rearguard(postgvardio)
retener	detain, hold back, retain(reteni)
retirarse	retreat(retiri?i)
retiro	isolation, separation(izoliteco)
retraso	delay, retardation(malfrui?o); adjournment, delay(prokrasto)
retratar	depict, represent(figuri)
retrato	image, picture(bildo); figure, diagram, image, picture, representation(figuro)
retrete	toilet(necesejo)
retroceder	go back, gobackwards(posteniri)
retroceso	decline, goingdown(regreso)
retrovisor	drivingmirror(retrospegulo)
retrógrado	backward, retrograde(retroira)
reumatismo	rheumatism(re?matismo)
reunir	join, unite(kunigi); join, unite(unuigi)
reunirse	join(ali?i)
reunión	joining, junction(kuni?o)
revelar	develop, reveal(riveli)
reverso	back, reverse, reverseside(dorsflanko)
revisar	examine(ekzameni); audit, check, check up on, supervise, verify(kontroli); revise(revizii)
revisor	guard(konduktoro)
revista	periodical(periodagazeto); magazine, periodical, revue(revuo)
revés	back, reverse, reverseside(dorsflanko); back, reverse, reverseside(malanta?aflanko); back, rear(malanta?aparto)
rey	king(re?o)
rezagado	laggard, straggler(postrestanto)
rezar	pray(pre?i)
reír	laugh(ridi)
reírse de	laughat(mokridipri)
reñir	quarrel, wrangle(kvereli)
rico	nice, tasty(bongusta)
ridiculizar	ridicule(ridindigi)
ridículo	ridiculous(ridinda)
riesgo	hazard, risk(risko)
rigido	rigid, stiff(rigida)
rinceronte	rhino, rhinoceros(rinocero)
riqueza	abundance, affluence, wealth(ri?eco)
risa	laughter(ridado)
ritmo	rhythm(ritmo)
riñón	kidney(reno)
robar	rob(pri?teli); steal(?teli)
roble	oak(kverko)
robo	abstraction, theft(?telo)
roca	reef(rifo); rock(roko)
rocío	dew(roso)
rodar	roll(ruli)
rodilla	knee(genuo)
rojo	red(ru?a); red(ru?a¹)
romano	Roman(roma); Roman(romano²); Roman(romia); Roman(romiano)
romería	pilgrimage(pilgrimado)
romper	break(rompi)
románico	Romanesque(romanika)
ron	rum(rumo)
roncar	snore(ronki)
ropa	clothes, clothing(vestoj)
ropa de la cama	bed?clothes, bedding(lita?o)
rosa	rose(rozo)
rosado	pink(rozkolora)
rostro	face(viza?o)
roto	broken(rompita)
rubio	blond, fair(blonda)
rueda posterior	back wheel, hind wheel, rearwheel(malanta?arado)
ruego	appeal, entreaty, supplication(petego)
ruido	ado, din, noise(bruo); sound(sono); agitation, riot, tumult(tumulto)
ruina	ruin(ruino)
ruiseñor	nightingale(najtingalo)
rumano	Romanian, Rumanian(rumana); Romanian(rumano)
rusa	Russianwoman(rusino)
ruso	Russian(rusa); Russian(ruso)
ruta	route(itinero); route(vojplano)
rábano	radish(rafaneto)
rábano picante	horse?radish, horseradish(kreno)
rápido	fast, quick, rapid, speedy, swift(rapida); fasttrain(rapidtrajno); fasttrain(rapidvagonaro)
récord	record(rekordo)
río	river(rivero)
río Amazonas	Amazon(Amazono)
saber	know, knowhow(scii)
sabido	well?known(konata)
saborear	taste(gustumi)
sacacorchos	corkscrew(korktirilo)
sacerdote	priest(sacerdoto)
sajón	Saxon(saksa); Saxon(sakso)
salario	salary, wage, wages(salajro)
saldar	liquidate(likvidi); pay(pagi)
salida	demand, sale(debito); exit, wayout(elirejo); departure(forveturo)
salida del sol	sunrise(sunlevi?o)
salir	exit, goout(eliri); absent onself, depart, go away, leave(foriri); drive away, driveoff(forveturi)
salmo	psalm(psalmo)
salmón	salmon(salmo)
salsa	gravy, sauce(sa?co)
salsa de malzanas	apple?sauce(pomka?o)
salsa de manzanas	apple?sauce(pomkompoto)
saltamontes	grasshopper, locust(akrido)
saltar	jump, leap, spring(salti)
salteo	assault(atenco)
salto	jump, leap(salto)
salud	health(sano)
saludar	greet, salute(saluti)
saludo	greeting, salutation(salutado); greeting(saluto)
salvar	keep, save, rescue(savi)
salvia	sage(salvio)
salvo	bar, barring, except for, subject to, withoutprejudice(kunrezervopri)
sanar	recover(resani?i)
sandalia	sandal(sandalo)
sandwich	sandwich(sandvi?o)
sangrar	bleed(sangellasi)
sangre	blood(sango)
sangría	bleeding, blood?letting(sangellaso)
santa	saint(sanktulino)
santo	saint(sanktulo)
sapo	toad(bufo)
saque de comienzo	kick?off(ekludo)
sartén	frying?pan, fryingpan(pato)
sastre	tailor(tajloro)
satélite de la tierra	earthsatellite(artefaritasatelito)
sauce	willow(saliko)
secar	dry(sekigi)
sección	section(sekcio)
seco	dry(seka)
secreción	secretion(sekrecio)
secreto	hidden(ka?ita); secret(sekreta)
secta	sect(sekto)
sed	thirst(soifo)
seducir	attract, draw(allogi)
segregar	divide, separate(apartigi)
seguido	directly, straighahead(rekte); straight ahead, straightalong(rekteanta?en)
seguir	follow(sekvi)
segundo	second(dua); second(sekundo)
seguridad	safety, security(sekureco)
seguro	insurance(asekuro); safe, secure(sekura)
seis	six(ses)
sellar	mark, stamp(stampi)
sello	stamp, postagestamp(po?tmarko)
sello de correos	stamp, postagestamp(po?tmarko)
semanalmente	weekly(?iusemajne)
sembrar	sow(semi)
semejante	like, alike, similar(simila)
sencillo	simple, straightforward(simpla)
sendero	path(vojeto)
sensible	sensitive(sentiva)
sentarse	sitdown(eksidi); sitdown(sidi?i)
sentencia	decision, judgement(ju?adecido)
sentimiento	feel, feeling, sensation(sento)
sentir	be sorry about, regret(beda?ri); feel, sense(senti)
sentirse	feel(sentisin)
separación	separation, partition(apartigo); isolation, separation(izoliteco)
separado	apart, particular, separate, special(aparta); remote(izolita)
separar	divide, separate(apartigi)
septiembre	September(septembro)
ser	be(esti¹)
sereno	serene, untroubled(serena)
serie	series, set(serio)
serio	earnest, serious, staid(serioza)
serpiente	serpent, snake(serpento)
servicial	accommodating, helpful(helpema)
servicio	service, worshipservice(diservo); attendance, service, waiting(servado); house charge, servicecharge(servamono); service(servo)
servilleta	napkin(bu?tuko)
servir	accomodate(fariservon); serve(servi); serve(surtabligi)
ser arrojado a la playa	bewashedashore(alna?i); bewashedashore(surbordi?i)
ser de	belongto(aparteni)
ser partidario de	adhereto(estiadeptode)
ser presuntuoso	attitudinize, pose, putonairs(afekti)
sesenta	sixty(sesdek)
seta	fungus, mushroom(fungo); mushroom(?ampinjono)
seudónimo	pseudonym(pse?donimo)
severo	severe, strict(severa)
sexo	sex(sekso)
sexto	sixth(sesa)
sexual	generative, sexual(seksa)
seña	character, mark, sign, signal, token(signo)
señal	mark, sign, signal, token(signalo)
señas	address(adreso)
señorita	madam, Mrs.(sinjorino²)
si	as, like, suchas(kiel³); if, providedthat(se)
siberiana	Siberian(siberia)
siberiano	Siberian(siberiano)
sidra	cider(cidro)
siempre	constantly, continually, continuously(da?re); always, ever(?iam)
sien	temple(tempio)
sierra	mountainchain(montaro); chain of mountains, mountain chain, mountain range, rand(monto?eno); saw(segilo)
siete	seven(sep)
siglo	centennial, century(jarcento)
significar	imply, mean, signify(signifi)
siguiente	following, next(sekvanta)
silbar	whistle(fajfi)
silencio	calm, quiet, silence(kvieto); silence(silento)
silla	chair(se?o)
sillón	armchair(brakse?o)
simple	simple, straightforward(simpla)
sin	without(sen)
sincero	above?board, honest(honesta); above?board, sincere(sincera)
sin aliento	breathless(senspira)
sin duda	no doubt, undoubtedly(sendube)
sistema	system(sistemo)
sitiar	besiege(sie?i)
sitio	place(ejo); location, place, spot(loko); seat(sidejo); siege(sie?o)
sobre	envelope(koverto); on, upon(sur)
sobretodo	above all, especially, chiefly, mainly, principally(precipe); chiefly(?efe)
sobre todo	above all, especially(anta??io)
sobrino	nephew(nevo)
sofocar	choke, quell, suffocate, suppress(sufoki)
sol	sun(suno)
solicitación	request(peto)
solicitar	ask, ask for, beg, bid, request(peti)
solicitud	request(peto)
sollo	sturgeon(sturgo)
solo	alone, only, sole, solitary(sola)
soltero	single, unmarried(fra?la)
solterona	unmarried woman, spinster(fra?lino¹)
solterón	bachelor(fra?lo¹)
sombra	shadow(ombro¹); shade(ombro²)
sombrero	hat(?apelo)
somero	shallow, superficial(malprofunda)
sonido	sound(sono)
sonreír	smile(rideti)
sonrisa	smile(rideto)
sopa	soup(supo)
soplar	blow(blovi)
sordo	deaf(surda)
sorprender	surprise(surprizi)
sorpresa	surprise(surprizo)
sosegado	calm, tranquil(trankvila)
sosegar	appease, calm, quiet, soothe, still(trankviligi)
sosegarse	abate, subside(kvieti?i); calmdown(trankvili?i)
sospecha	suspicion(malfido); suspicion(suspekto)
sospechar	suspect(suspekti)
sostener	abet, support, sustain(subteni)
sostén	bra(mamzono)
soñar	dream(son?i)
su	her, his, its, their(sia); her(?ia)
subasta	tender(prezkonkurado)
subir	ascend, get up, go up, lift, rise, arise(levi?i); ascend, climb, goup(supreniri)
subir a	ascend, climb, scale(surgrimpi)
subscripción	subscription(abono)
subscriptor	subscriber(abonanto)
substantivo	noun, substantive(substantivo)
substituir	taketheplaceof(anstata?i); replace, substitute(anstata?igi)
subyugar	govern, head up, restrain(estri); control, govern, restrain, rule(regi)
sucesivamente	consecutively(sinsekve)
sucesivo	following, next(sekvanta)
sucinto	concise(konciza)
sucio	dirty, filthy, nasty, soiled, unclean(malpura)
sudafricano	SouthAfrican(sudafrika)
sudamericano	SouthAmerican(sudamerika)
sudar	sweat(?viti)
sudor	perspiration, sweat(?vito)
sueco	Swedish(sveda); Swede(svedo)
suela	sole(plandumo)
suelo	bottom, foundation, ground(fundo); floor(planko)
suelto	loose(nefiksita)
suerte	destiny, fate, fortune, luck(sorto); kind, sort(speco); chance, luck(?anco)
sueño	sleep(dormo); dream(son?o)
suizo	Swiss(svisa); Swiss(sviso)
sujetador	bra(mamzono)
sujetar	hang onto, hold(teni)
suma	amount, sum(sumo)
sumar	add up, sumup(sumigi)
superficie	summit, surface, top(supra?o)
supermercado	supermarket(memservavendejo); supermarket(supermarkto)
suplemento	replacement, replenishment, supplement(kompletigo)
suplicar	implore, invoke(elpetigi)
suponer	guess, presume, suppose, surmise(supozi)
sur	south(sudo)
surtido	assortment(sortimento)
suscribirse	subscribe, subscribeto(ekaboni)
suscripción	subscription(abono)
suscriptor	subscriber(abonanto)
suspender	reject(malakcepti)
suspicaz	suspicious(malfida); suspicious(malfidema); suspicious(suspektema)
suspirar	sigh(suspiri)
sustraer	subtract(subtrahi)
sábana	sheet(littuko)
séptimo	seventh(sepa)
sí	yes(jes)
sólido	firm, robust, sturdy(fortika); firm, solid(solida)
sólo	exclusively, just, only(nur)
sótano	basement, cellar(kelo)
tabaco	tobacco(tabako)
taberna	bar, pub(drinkejo)
tabique	wall(vando)
tabla	shelf(breto); lath, slat(lato); board, plank(tabulo)
tabla de planchar	ironingboard(gladotabulo)
taburete	barstool(trinkejatabureto)
taco	nail(najlo); taco(tako)
tacón	heel(kalkanumo)
tajada	slice(tran?a?o)
tal	such, such a, thatkindof(tia)
talento	aptitude, disposition, talent, turn(naturdoto)
talentoso	gifted, talented(naturdotita); accomplished, talented(talenta); gifted, talented(talentplena)
taller	workplace(laborejo)
talonario	cheque?book(?ekaro)
talón	heel(kalkano); acknowledgement, receipt(ricevatesto)
tal vez	maybe, mayhap, perchance, perhaps, possibly(eble)
tamaño	dimension, measurement(dimensio); size(grandeco)
también	also, likewise, too(anka?)
tambor	drum(tamburo)
tampoco	neither, nor(nek)
tampón	plug, tampon(tampono)
tanque	cistern, tank(cisterno); tank(rezervujo)
tantico	a little, rather(iomete)
tanto	thatmuch(tiom)
tapacubo	hub?cap(nabo?apo)
tapicero	paperer, paper?hanger(tapetisto)
tapizar	paper(tapeti)
tapon	hub?cap(nabo?apo)
taquilla	window, ticket?window(gi?eto)
tardar	be kept in, be detained, remain, stayon(postresti)
tarde	afternoon(posttagmezo); evening(vespero)
tardío	late, tardy(malfrua)
tarjeta	card, map, menu(karto); postcard(po?tkarto)
tarjeta de crédito	creditcard(kreditkarto)
tarjeta postal	picturepostcard(bildkarto); postcard(po?tkarto)
tarjeta postal ilustrada	picturepostcard(bildkarto); picturepostcard(ilustritapo?tkarto)
tarta de manzana	apple?tart(pomtorto)
tasa	assessment(impostkvoto)
taxi	taxi(taksio)
taza	cup(taso)
teatro	theatre(teatro)
teatro de varietés	varietyentertainment(varieteo)
tejado	roof(tegmento)
tela	bit, lump, piece(peco); cloth, material(?tofo)
telegrama	telegram(telegramo)
telemando	remotecontrol(telefunkciigo)
televisión	television, TV(televido)
teléfono	telephone(telefono)
temer	be afraid of, fear(timi)
temeroso	afraid(malkura?a); afraid(tima); horrible(timiga)
temor	fear(timo)
temperatura	temperature(temperaturo)
tempestad	storm(?tormo)
templo	temple(templo)
temporada	season(sezono)
temprano	early(frue)
tenazas	pincers(pin?tenajlo); tongs(prenilo); pincers, pairofpincers(tenajlo)
tenedor	fork(forko)
tenedor de libros	book?keeper(librotenisto)
tener	desire, wish(deziri); have, havegot(havi); own, possess(posedi); hang onto, hold(teni)
tener cuidado	advert, pay attention, pay attention to, watchoutfor(atenti)
tener el propósito	intend, mean(intenci)
tener lugar	come about, happen, occur(okazi)
tener puesto	wear(surhavi)
tener que	have to, must, ought to, should(devi)
tener éxito	succeed(sukcesi)
tenga	behold, here is, here are, look, there(jen)
tenis	tennis(teniso)
tensión	tension(stre?i?o)
tentación	disposal, inclination, tendency(inklino); temptation(tento)
tercero	third(tria)
tercio	third(triono)
terciopelo	velvet(veluro)
terminado	completed, done, finished, over, through(finita)
terminante	effective, effectual, efficacious(efika)
terminar	accomodate, end, finish, terminate(fini)
terminarse	end, come to an end, end up, expire(fini?i)
termos	thermosbottle(termoso); thermos, thermosflask(varmbotelo)
termómetro	thermometer(termometro)
ternero	calf(bovido)
terraza	terrace(teraso)
terremoto	earthquake(tertremo)
terrenal	terrestrial(surtera); earthen, earthly, terrestrial(tera); terrestrial(tergloba)
terreno	ground, grounds, terrain(tereno)
terreno del camping	camping ground, campingsite(kampadejo)
terreno pantanoso	marsh, swamp(mar?o)
terrestre	terrestrial(surtera); earthen, earthly, terrestrial(tera); terrestrial(tergloba)
testigo	witness(atestanto)
tetera	teapot(tekru?o); tea?pot(teujo)
texto	lyric, text(teksto)
teñir	dye, tint(tinkturi)
tibio	lukewarm(varmeta)
tiburón	shark(?arko)
tiempo	time, while(tempo); weather(vetero)
tienda	boutique, shop, store(butiko)
tienda de campaña	tent(tendo)
tierno	soft(mola)
tierra	earth, land, soil(tero)
tigre	tiger(tigro)
tijeras	scissors(tondilo)
tijera para setos	hedge clippers, hedgeshears(he?tondilo)
tilo	lime?tree, linden?tree(tilio)
timbrar	mark, stamp(stampi)
timbre	bell(sonorilo); bell(tintilo)
timbre de alarma	alarmbell(alarmsonorilo)
timón	handlebars, helm, rudder(direktilo); rudder(rudro)
tinieblas	darkness, murk(mallumo)
tinta	ink(inko)
tirantes	braces, suspenders(?elkoj)
tirar	fire, shoot(pafi); drag, draw, haul, pull, tug(tiri)
titubear	hesitate(heziti); hesitate, waver(?anceli?i)
toalla	towel(mantuko)
tobillo	ankle(maleolo)
tocar	touchupon(ektu?i); play(ludi); play(ludi²); sound(soni); touch(tu?i)
tocino	bacon(lardo)
todavia	still, yet(ankora?)
toda clase de	all, everykindof(?ia); all sorts, all sorts of, miscellaneous, ofallsorts(?iuspeca)
todo	entire, overall, whole(tuta); all, altogether, everything(?io)
todopoderoso	almighty, all?powerful, omnipotent(?iopova)
todos	all(?iuj)
tolerar	endure, put up with, tolerate(toleri)
tomar	accept, receive, take, takein(akcepti); engulf, swallowup(engluti); get, lay hold of, pick up, take(preni)
tomar en consideración	account, consider, esteem, regard, takeintoaccount(konsideri)
tomate	tomato(tomato)
tomo	volume(volumo)
toque	touch(ektu?maniero); touch(fingrofrapo)
torcido	furious(kolerega)
tormenta	storm(?tormo)
tornillo	screw(?ra?bo)
toro	bull(ta?ro)
torre	castle, tower(turo)
torta	pie, tart(torto)
tortilla	omelette(omleto)
toser	cough(tusi)
trabajador	hand, laborer, labourer, operative, worker, working man, workman(laboristo)
trabajar	work(labori)
trabajo	job, work(laboro)
traducir	translate(traduki)
traer	bring, fetch(alporti)
tragar	engulf, swallowup(engluti); swallow(gluti)
traje	costume, outfit, suit(kostumo)
traje de baño	bathing suit, bathing?suit(bankostumo)
tranquilo	calm, tranquil(trankvila)
transbordador	ferry(pramo)
transitable	passable, practicable(irebla); passable, practicable(surirebla)
transitivo	transitive(transitiva)
transpirar	sweat(?viti)
transportar	transport(transporti)
transporte	transport(transporto)
tranvía	streetcar, tram(tramo)
tras	behind, after(malanta?)
trasladar	copy(kopii)
traslado	copy(kopio)
trasporte	transport(transporto)
trastornar	overthrow, turn, turn over, upset(renversi)
tratado	treaty(traktato)
tratamiento	treatment(manipulado); treatment(pritraktado); treatment(traktado)
tratar	treat(pritrakti); deal with, handle, treat(trakti)
tratar de	aim, attempt, endeavour, take steps, undertake(klopodi)
trato	treatment(traktado)
trece	thirteen(dektri)
treinta	thirty(tridek)
tremblar	quiver, shiver, tremble(tremi)
tren	train(trajno); train(vagonaro)
tren corrido	corridortrain(D?trajno)
trepar	climb(grimpi)
tres	three(tri)
tresillo	lounge suite, three?piecesuite(benkse?aro)
tres veces	three times, thrice(trifoje)
tributo	tax(imposto); tribute(tributo)
tricar	carrier cycle, carriertricycle(transportbiciklo)
trigo	wheat(tritiko)
trillado	hackneyed(gurdita); hackneyed, hard?worked, stale, trite, worn?out(tedebanala)
trinquete	clique, coterie, junto, set(kliko)
tripulación	crew(homekipo); crew(?ipanaro)
triste	sad(afliktita); bleak, dismal, dreary, gaunt, miserable, sad, somber(malgaja); dismal, gaunt, miserable, sad(mal?oja)
tristeza	sadness, sorrow(mal?ojo)
trivial	commonplace, dismal, trite(banala)
trombón	trumpet(trumpeto)
tronar	thunder(tondri)
tronco	stem, trunk, tree?trunk(arbotrunko); stem, trunk(trunko)
trono	throne(trono)
trozo	slice(tran?a?o)
trucha	trout(truto)
trueno	thunder(tondro)
tráfico	traffic(trafiko)
tráfico de dirección única	one?waytraffic(unudirektatrafiko)
tu	your(cia); your(via)
tubo receptor	cathodetube(bildotubo); cathodetube(bildvalvo)
tuerca	nut(boltingo); nut(?ra?bingo)
tumba	grave, tomb(tombo)
tumor	tumor, tumour(tumoro)
turca	Turkish lady, Turkishwoman(turkino)
turco	Turkish(turka); Turk(turko)
turista	tourist(turisto)
turno	file, line, rank, row, turn(vico)
tutear	theeandthou(cidiri)
tápa	cover, hood, lid(kovrilo)
té	tea(teo)
técnica	technics, technique(tekniko)
término	end, ending(fino)
tía	aunt(onklino)
tímido	afraid, timid(timema)
tío	uncle(onklo)
título	superscription(surskribo)
tóxico	poisonous(venena)
tú	thou, you(vi¹); thou, you(vi?)
túnel	tunnel(tunelo)
uf	shame(fi)
ultrajar	abuse, insult, offend(ofendi)
un	one(unu); a, an(nedifinaartikolo)
una	one(unu); a, an(nedifinaartikolo)
unas	a few, any, some(kelkaj)
una vez	once, onetime(unufoje)
unirse	associate, join, pool(unui?i)
universal	general, usual(?enerala)
universidad	university(universitato)
unión	joining, junction(kuni?o)
uno	one(unu)
unos	a few, any, some(kelkaj)
uno y medio	oneandahalf(unukajduono)
un momento	a few minutes, amoment(momenton)
urbano	urban(urba)
urgente	pressing, urgent(ur?a)
urgentemente	urgently(ur?e)
urraca	magpie(pigo)
usado	worn(eluzita); used(uzita)
usar	use up, wearout(eluzi); employ, use, makeuseof(uzi)
uso	use(uzo)
usted	thou, you(vi¹); ye, you(vi³)
ustedes	ye, you(vi?)
uva	grape(vinbero)
uña	nail(ungo)
vaca	cow(bovino)
vacaciones	vacation(ferioj)
vaciar	empty(malplenigi); bottle(spili)
vacilación	hesitation, wavering(hezitado); hesitation(hezito)
vacilar	hesitate(heziti); hesitate, waver(?anceli?i)
vacío	empty, void(malplena)
vainilla	vanilla(vanilo)
vale	agreed, okay(konsentite)
valer	beworth(valori)
valle	valley(valo)
valor	courage(kura?o); value, worth(valoro)
valorar en	blame, holdagainst(imputi)
valuta	currency(valuto)
vampiro	vampire(vampiro)
variar	vary(varii)
variedad	variety(vario)
varios	several(diversaj)
vasco	Basque(vaska); Basque, Basquelanguage(vaskalingvo); Basque(vasko)
vascuence	Basque(vaska); Basque, Basquelanguage(vaskalingvo)
vaso	glass(glaso); vase, vessel(vazo)
vecino	adjacent(apuda); adjacent, adjoining(limtu?anta); adjacent, nearby, neighbouring(najbara); neighbour(najbaro)
vegetación	vegetation(vegeta?aro)
vegetariano	vegetarian(vegetarano)
veinte	twenty(dudek)
veinte y uno	twenty?one(dudekunu)
vejiga	bladder, bubble(veziko)
vela	candle(kandelo)
velludo	hairy, hirsute(harkovrita)
velocidad	speed(rapido)
velocidad inicial	initialvelocity(komencrapido)
vena	vein(vejno)
vencimiento	end, terminate(fini?o)
vendaje	bandage(banda?o); bandage(pansa?o)
vendar	dress(pansi)
vendedor	salesman(vendisto)
vendedora	saleswoman(vendistino)
vender	dispose of, sell, vend(vendi)
veneno	poison(veneno)
venganza	revenge, vengeance(ven?o)
vengar	avenge, avengeoneself(ven?i)
venir	come(veni)
venir después	arrive afterwards, come afterwards, come later, follow(veniposte)
venta	sale(vendo)
ventaja	advantage, benefit(avanta?o); advantage, benefit(utilo)
ventana	window(fenestro)
ventilador	electric fan, ventilator(ventolilo)
ventilar	aerate, air out, give an airing, ventilate(aerumi)
ver	see(vidi)
verano	summer(somero)
verbena	fair(kermeso)
verdad	reality, truth(vero)
verdaderamente	absolutely, genuinly, indeed, really, truly(vere)
verdadero	true(vera)
verde	green(verda); green(verdo)
verduras	vegetable(legomo)
vergonzoso	ashamed(hontigita); humiliating(humiliga)
vergüenza	shame(honto)
vermut	vermouth(vermuto)
verter	pourin(enver?i)
vestido	dress, gown, robe(robo)
vestir	cover, overlay(tegi); clothe, dress(vesti)
vestirse	dress, getdressed(vesti?i); dress(vestisin)
vestíbulo	hall(halo)
veterinario	veterinarian(bestkuracisto); veterinarian(veterinaro)
viajar	travel(voja?i)
viaje	journey, trip, voyage(voja?o)
viajero	traveller(voja?anto)
viaticar	administerthelastsacraments(sanktolei)
victoria	victory(venko)
vida	life(vivo)
vidrio	glass(vitro)
viejo	old(maljuna); old(malnova)
viento	wind(vento)
vientre	abdomen, belly, tummy(ventro)
viernes	Friday(vendredo)
viga	beam, girder(trabo)
vigilar	guard, keep, look after, watchover(gardi)
vinagre	vinegar(vinagro)
violento	acute, intense, intensive(intensa)
violoncelo	cello(violon?elo)
virtud	energy(energio); force, strength, vigour(forto); courage(kura?o); ability(povo); morality, vice(virto); chastity, purity(?asteco)
visado	visa, visé(vizo)
visita	visit(vizito)
visitación	inspection(inspektado)
visitar	attend, call on, see, visit(viziti)
vista	appearance, aspect, look, sight, view(aspekto); exterior(ekstera?o); view(elvido); view(panoramo); examination(rigardado); sight, view(vido)
vitamina	vitamin(vitamino)
viudo	widower(vidvo)
vivir	be alive, live(vivi)
vivo	alive(vivanta)
viña	vine(vitejo)
volante	handlebars, helm, rudder(direktilo); joystick, steering?wheel(stirilo)
volar	fly(flugi)
voltaje	tension, voltage(tensio)
voluntad	will, willingness, wish(volo)
voluntariamente	willingly(volonte)
volver	turnaway(forturni); go back, return(reiri); come back, return(reveni); turn, turn around, turnround(turni)
vomitar	throw up, vomit(vomi)
vosotras	you(vi?)
vosotros	you(vi?)
votar	vote(vo?doni)
voz	voice(vo?o¹)
vuelo	flight(flugo)
válido	valid(valida)
válvula	tube, valve(valvo)
vía	path, road, way(irejo); road, route, way(vojo)
víbora	adder, viper(vipuro)
xilófono	xylophone(ksilofono)
y	and(kaj)
ya	already, by now, yet(jam)
yate	yacht(ja?to)
ya ... no	nolonger(neplu)
ya que	because, forthereasonthat(protioke); because, forthereasonthat(tialke); as, because, for, since(?ar)
yedra	ivy(hedero)
yerba	grass(herbo¹)
yerno	son?in?law(bofilo)
yerro	aberration, error, mistake(eraro)
yo	I(mi¹); I(mi²); I(mi³); I(mi?)
yodo	iodine(jodo)
yogur	yoghourt, yoghurt(jogurto)
yugo	yoke(jugo)
y tambien	and also, and ... as well, as well as, togetherwith(plie)
y también	and also, and ... as well, as well as, togetherwith(kajanka?)
zalamero	affectionate, caressing, cuddlesome, cuddly(karesema)
zambullirse	dive, plunge(plon?i)
zanahoria	carrot(karoto)
zanja	hole, ditch, pit(fosa?o)
zapatero	shoemaker(?uisto)
zapatilla	slipper(pantoflo)
zapato	shoe(?uo)
zarza	blackberry, blackberry bush, bramble(rubuso)
zarzamora	blackberry(rubusbero)
zelandés	Zealand(zelanda); Zealander(zelandano)
zinc	zinc(zinko)
zona	zone(zono²)
zorro	fox(vulpo)
zote	addled, foolish, stupid(stulta)
zumo	juice, sap(suko)
zumo de naranja	orangejuice(oran?osuko)
zurrar	thrash(bategi)
África	Africa(Afriko)
África del Sur	SouthAfrica(Sudafriko)
ágata	agate(agato)
ágil	adroit, clever, dexterous, skillful(lerta)
águila	eagle(aglo)
álamo	poplar(poplo)
álbum	album(albumo)
álgebra	algebra(algebro)
ámbar amarillo	amber(sukceno)
ángulo	angle(angulo¹)
árabe	Arabian, Arabic(araba); Arab(arabo)
árbol	tree(arbo)
árido	barren(senfrukta); dreary(senkultura)
áspero	coarse, rough(malglata); severe, strict(severa)
áspid	adder, viper(vipuro)
átomo	atom(atomo)
ávido	acquisitive, eager, greedy(avida)
él	he, him(li)
ídolo	idol(idolo)
ópera	opera(opero)
óptico	optician(optikisto)
órbita	orbit(orbito)
úlcera	ulcer, sore(ulcero)
último	last(lasta)
único	alone, only, sole, solitary(sola); unique(unika)
útero	uterus, womb(utero)
ñajú	gumbo, okra, okraplant(gumbo)
ñame	yam(ignamo)
ñandu	American ostrich, nandu(nanduo)
ñaña	elder sister(plimaljunafratino)
